身热肢寒	热深厥深身热肢寒 阴盛格阳身热肢寒
腹中痞块	气滞血班腹中痞块 痰食凝结腹中痞块 中气虚损腹中痞块
闭经溢乳	脾胃气虚闭经溢乳 肝郁化火闭经溢乳
近视	肝肾两虚老花眼 阴精不足远视 气虚神伤近视 肝肾亏虚近视
顿咳	痰热阻肺顿咳 风寒痰阻顿咳 肺聛两虚顿咳
耳痛	气血瘀阻耳痛 风热犯肺耳胀闷 肝胆湿热耳胀闷 风热邪毒耳痛 肝胆热毒耳痛
舌颤	血虚舌颤 酒毒舌颤 肝风舌颤
气喘	气郁伤肺气喘 肾不纳气脐下悸动 风热犯肺气喘 痰浊阻肺气喘 肺气虚弱颜面浮肿 蜃邪中人晕厥 走马牙疳 肺热咳嗽 肺气阴两虚气喘 肾虚痰阻气喘 气阴两虚胸痛 肾不纳气气喘 风寒束表恶寒 脾气亏虚胎水肿满 风寒闭肺气喘 寒邪客肺畏寒 阳虚水泛气喘 表寒里热气喘 寒犯少阴口唇靑紫
悬雍下垂	火毒内侵悬雍下垂 气滞血淤悬雍下垂
咽喉白腐	时行疫毒咽喉白腐 疫毒凌心咽喉白腐 肺胃热盛咽喉白腐 阴虚火旺咽喉白腐 肺肾阴虚咽喉白腐 痰浊壅闭咽喉白腐 肾阳虚寒咽喉白腐 疫毒内盛咽喉白腐
腰背俯偻	精血亏虚腰背俯偻 宗气不足腰背俯偻 肾气亏虚腰背俯偻
舌蒌	心脾两虚舌蒌 痰湿阻络舌蒌 肝肾阴虚舌蒌 肺热熏灼舌萎
滑胎	血瘀滑胎 肾气亏虚滑胎 气血两虚滑胎 相火偏旺滑胎
妊娠消渴	胃火炽盛妊娠消渴 胃阴亏虚妊娠消渴 肝郁化火妊娠消渴
胎漏	外伤胎漏 血热胎漏 肾气虚胎漏 血虚胎漏 气虚胎漏 虚热胎漏
妄听妄视	痰气郁结妄听妄视 痰火扰心妄听妄视 气血两虚妄听妄视 阴虚火旺妄听妄视 热入血室妄听妄视
肩背痈肿	火毒凝结肩背痈肿 瘀血凝结肩背痛肿 署湿籩结肩背痈肿
健忘	肝阳上亢面色红 热灼肾阴舌苔灰黑 心血不足经行情志异常 心肾阴虚心胸汗出 肾阳虚脱肛 褒血犯头偏头痛 血虚面色白 贤虚供亏痫 心气虚独语 心肾不交多梦 心脾两虚不寐 阴虚火炎舌衄 血虚月经过少 心脾气虚小儿多动 肾精亏虚头昏 阴虚火旺烦躁 气血两虚老花眼 血虚风燥皮肤肥厚 肾阳虚衰嗜睡 肾精不足善恐 心脾两虚经断前后诸症 心肾不交梦游 心脾两虚视物变形 肝肾亏虚半身不遂 心脾气虚心胸汗出 心肾不交不寐 心脾两虚脑鸣 血虚舌麻 肾精亏虚面色黧黑 心血虚舌不知味 肝肾亏虚四肢强直 肾阴亏损云翳 肾精不足骨痛 肾精亏虚手舞足蹈 心睥两虚言语错乱 精血亏虚腰背俯偻 心肾不交耳聋 心脾两虚健忘 血虚舌颤 血虚神闭痫 气虚神伤近视 痰浊扰心健忘 贤精亏虚健忘 心阴亏虚不寐 心脾两虚舌蒌 心肾不交健忘 肝肾不足转筋 瘀血攻心健忘 酒毒舌颤 心脾两虚善疑 肝阳上亢耳聋
产后身痛	风寒产后身痛 血疲产后身痛 血虚产后身痛
皮肤紫斑	湿热下注紫斑 血热妄行紫斑 脾肾阳虚紫斑 脾不摄血紫斑 瘀血阻滞紫斑 寒凝血疲紫斑
食后困顿	痰湿中阻食后困顿 脾气虚食后困顿
臁疮	血瘀气滞臁疮 湿热下注臁疮 脾虚湿盛臁疮 肝肾阴虚臁疮
小便挟精	湿热内蔥小便挟精 肾虚失藏小便抉精 阴虚火旺小便挟精
骨痛	气血两虚云雾移睛 气滞血淤骨痛 湿热阻痹骨痛 寒湿阻络骨痛 肾精不足骨痛 睥肾气虚骨痛 肝肾亏虚四肢疼痛
黑睛星翳	风热余邪云翳 胃阴不足云翳 肝热受风经行目痛 热毒壅盛星翳 气血两虚星翳 肾阴亏损星翳 肝经风热星翳
角弓反张	疫毒凌心咽喉白腐 热盛动风啮舌 金疮风毒项强 热极或湿热生风四肢抽搐 血虚产后发痉 阳明热织角弓反张 邪热伤津项强 热盛动风神昏 热动肝风面色青 风热上攻目偏视 热盛动风啮齿 风寒产后发痉 寒湿阻络角弓反张 外伤风毒口噤 热毒内陷营血鼻肿 气血两虚动风角弓反张 风邪入侵四肤强直 金创风毒角弓反张 里热壅盛口噤 邪毒炽盛产后发疫 血热风盛角弓反张
舌肿	外感风寒舌肿 心脾积热舌肿 心经积热舌肿 脾虚寒湿舌肿 肝火上炎舌衄
小儿水痘	外感风热水痘 毒热炽盛水痘
初生不啼	青紫窒息不啼 苍白窒息不啼
痄腮	风热上犯痄腮 邪毒引皋窜腹 邪毒内陷心肝 热毒炽盛痄腮
舌裂	阳明实热舌裂 阴虚津亏舌裂
干呕	胃阴虚胃痈 脾胃虚弱经行呕吐 肝郁干呕 湿热蕴蒸口渴 风邪袭表恶风 脾胃阴虚手足汗出 食滞干呕 客气上逆痞 胃阴虚舌剥 风痰入络手颤 胃热干呕 痰湿中阻扬鸣 胃阴干涸舌光 胃寒干呕 胃阴不足呕吐
半身麻木	风疲入络流涎 痰火化风喉中痰鸣 风寒袭络半身麻木 肝风内动半身麻木 湿疲阻络半身麻木 脾胃气虚半身麻木 营虚半身麻木
呃逆	肝气犯胃食欲不振 胃阴虚胃痈 胃火呃逆 胃阴不足呃逆 肝火犯胃吐血 疾气互结反胃 胃寒气逆呃逆 脾肾阳虚呃逆
经行腹痛	气血两虚经行旗痛 冲任虚寒经行腹痛 肝郁气滞经行腹痛 寒湿凝滞经行政痈 湿热菹结经行睃痛 肝肾阴虚经行腹痛
胎弱	肺气不足胎弱 肾气不足胎弱 脾气不足胎弱 肝气不足胎弱 心气不足胎弱
腋窝红肿	肝郁血热腋窝红肿 火毒凝滞腋窝红肿
臀部痈肿	邪热结聚臀部痈肿 火毒盖结臀部痈肿
脱形	气血两虚脱形 精血亏虚脱形 脾气虚脱形
小便不利	水饮凌心小儿心悸 脾阳不振小便不利 湿热熏蒸头汗 寒湿发黄 肾阳虚衰小便不利 风湿外袭恶风 表寒郁热烦躁 水停下焦脐下悸动 肺气失宣小便不利 酒毒内茧舌紫 湿热内阻小便不利 阳气郁阻手足厥冷 脾肾不足煤形红斑 水气凌心心下悸 气滞湿阻小便不利 寒湿困脾口腻 营卫壅闭黄汗 脾胃虚寒异嗜
善太息	气虚善太息 肝郁气滞善怒 肝郁化火妊娠心烦 肝郁气滞脏躁 肝郁气滞须发早白 肝气郁结梦游 肝郁气滞憋气 肝郁气滞胁痛 气郁血虚痴呆 肝经郁热不寐 肝郁妊娠心腹胀满 痰气郁结妄听妄视 肝郁气滞腹筋挛急 气滞肌表四肢肿胀 肝郁气结言语错乱 褒气郁结独语 胆虚气怯不寐 肝郁善太息 气滞妊娠小便不通
小儿手足心热	血虚阴亏手足心热 疳积脾虚手足心热
牙龈出血	肾阴虚火旺齿衄 脾不统血齿衄 胃火燔龈齿衄 胃热阴虚齿衄
臂痛	风寒湿阻臂痛 瘀血阻滞臂痛 痰湿流注臂痛 气血两虚臂痛
面色青	热动肝风面色青 肺寒咳痰 寒滞扬道面色青 心血瘀阻面色靑 热毒蕴肠异嗜 寒邪束表面色青 胎毒发寒 胃寒妊娠呕吐 心肾阳衰面色青 心气不足胎弱 气滞血瘀单腹胀大 寒湿凝滞妇人腹痛
颈间生疮	肝胃积热颈间生疮 肺胃火热颈间生疮 肝郁血瘀颈间生疮 肝郁疲凝颈间生疮
经期延长	脾气虚弱月经过多 月经过少 阴虚血热经期延长 湿热蓬结经期延长 气滞血嵌经期延长 阴虚血热带环后阴道异常出血 气虚经期延长 肝郁血热带环后阴道异常出血 肝火偏亢月经过多 脾肾阳虚经期延长
目羞明	风热羞明 气虚风热爱明 气阴两虚羞明 风寒羞明
咽中异物感	肺热阴虚咽中异物感 痰凝气滞咽中异物感 肝气上逆咽中异物感
小儿尿频	肺气虚尿频 肝胆湿热尿频 肾阴虚尿频 睐胱湿热尿频 脾肾两虚尿频
眼胞瘀痛	后期眼胞瘀痛 早期眼胞疲痛
舌胖	脾气虚弱月经过多 脾虚湿滞经行浮肿 脾气虚少气 冲任虚寒腹冷 痰湿经行头痛 肝郁脾虚经前乳胀 气虛低热 脾虚夹湿睑弦赤烂 脾虚舌胖 肾虚水泛舌胖 脾虚湿滞胞睑肿胀 肾阳虚崩潘 气血两虚经行发热 痰浊阻滞梦游 脾气虚弱经行泄泻 脾胃菹湿口唇湿烂 脾气虚弱经断复行 脾肾亏虚步态不稳 脾不统血经行吐衄 脾肾阳虚经断前后诸症
天疱疮	心火脾湿夭疱疮 湿热熏蒸夭疱疮 气阴两虚天疱疮 毒热炽盛天疱疮 脾虚湿盛天疱疮
腰如绳束	带脉不利腰如绳束 肝经湿热腰如翔束
经前乳胀	肝郁气滞经前乳胀 肝郁化火经前乳胀 肝郁脾虚经前乳胀 肝郁肾虚经前乳胀 脾肾阳虚经行泄泻 肝郁血热带环后阴道异常出血 肝郁阴虚经前乳胀 肝脾气滞便难
腹筋挛急	肝郁气滞腹筋挛急 寒湿阻滞腹筋挛急 血不荣润腹筋挛急
小儿流涎	脾宵积热流铤 脾胃虚寒流瘅
便血	湿热便血 邪入血分发热 实热便血 脾不摄血紫斑 热入营血面色红 虚寒便血 气滞血瘀发癍 气血两虚便血 脾不统血红斑 虚热便血 血热动血汗血 热毒攻心神昏 瘟毒发黄 脾不统血舌衄 脾胃虚寒胃痛 湿热风毒紫癜 肝火犯胃宵痛 热入营血烦躁
畏寒	风热上犯痄腮 肾精亏虚下肢生疽:多发于儿童及靑年 肝肾虚腰膝无力 睐胱湿热尿频 肾阳虚脱肛 肾阳虚证口咸 脾肾阳虚腹露青筋 脾胃虚寒胃痛 风寒犯头头痛 脾肾两虚尿频 脾肾拓虚毛发脱落 风热上扰颜面红肿 腑肾阳虚食欲不振 沉寒痼冷精液清冷 肾阳虚衰嗜睡 脾肾阳虚脐腹痛 脾胃阳虚腹冷 阳虚寒盛寒战 胃寒妊娠呕吐 心阳虚畏寒 气阴两虚羞明 寒礙肝脉畏寒 阳气不足头汗 肾虚鼻流涕 脾肾阳虚单腹胀大 肾阳虚喷嚏 脾肾阳虚吐血 寒湿阻络骨痛 营卫不和自汗 脾胃虚寒食欲不振 寒邪客肺畏寒 阴寒内盛小便清长 肾阳虚寒咽喉白腐 脾胃气虚瘦废 肾阳虚妊娠小便不通 脾肾阳虚胎水肿满 气虚恶露不断 气血两虚乳汁不行 寒滞肝脉阴痛 脾阳虚畏寒 肾阳虚腰重 睥肾两虚尿道溢脓 肾阳虚畏寒 肾阳虚衰腰冷 脾虚寒湿舌淡白 气虚胎动不安 脾肾阳虚便秘 寒湿困脾畏寒 湿阻气滞胎死不下 寒湿束表无汗 肾阳衰微大便溏 脾胃不调鑕虫扰动症 阳虚水泛气喘 阳气欲脱绝汗 肾阳不足遗尿 寒滞经脉濡手指挛急 肾气不足耳聋
盗汗	阴虚火旺暴盲 肝阴虚阳亢头晕 阴虚火旺尿脓 相火偏旺性早熟 阴虚火旺汗血 肾阴不足遗尿 阴虚内热舌红绛 阴虚血燥闭经 心肾不交多梦 阴虚动风头摇 阴虚火旺心中懊侬 水火不济善喜 气阴两虚舌剥 血虚月经过少 阴精不足远视 心肺阴虚梦游 虚火上炎重舌 阴虚火旺妄听妄视 疳积脾虚手足心热 表虚不固多汗 肝肾阴虚血灌瞳神 肾精不足善恐 肝肾亏虚关节变形 脾胃积热多汗 肺阴虚消瘦 阴虚血热紫癜 心阴虚火旺心烦 肝肾阴虚白睛红赤 阴虚肺燥经行吐衄 阴虚血热乳头玻裂 肝肾阴虚瘫痪 邪阻半表半里盗汗 阴虚火旺咽喉白腐 阴虚五心烦热 心血不足盗汗 阴虚火旺咳血 血虚产后发热 肺热阴虚咽中异物感 疾热阴虚粟疹 肝肾阴虚月经过多 阴血不足善惊 虚热肛门疼痛 阴虚火炎胞内生肉 肝肾阴虚瘰疬 阴虚悉露不断 肾阴虚损鼻衄 心肾不交健忘 脾虚湿阻盗汗 肝肾阴虚便血 气阴两虚小儿心悸 阴虚血热不孕 肾阴亏虚尿痛 阴虚血亏潮热 气血两虚动风角弓反张 心阴虚心悸 阴虚血搡反胃 气血虚衰肛门流脓 气血两虚四肤瘦削 阴虚背热 心肺气虚善悲 阴血亏虚多汗 精血亏虚毛发变异 肾阴虚尿频 阴虚火旺红斑 精血亏虚脱形 肝肾阴虚视物变形 阴虚火炎舌衄 肾虚腰脊痛 肾阴虚火旺齿衄 肝肾阴虚阴疮 阴虚火旺烦躁 肝肾阴虚小便失禁 心阴亏虚小儿心悸 阴虚火旺口唇焦裂 肾阴亏损尿血 心肾不交脏躁 阴虚津亏木舌 阴虚火旺远视 肺燥阴虚鼻干 心肾不交梦游 阴虚咽痛 心肾不交不寐 虚热便血 心肝阴虚颈粗 阴虚内热面色红 肾阴亏虚尿频 阴血亏虚目视无神 肾精不足骨痛 肺脾肾虚肛周疮毒 心肾不交耳聋 虚热结聚胚周痈肿 阴虚肺燥咳痰 阴虚内热红丝赤缕 肝肾阴虚瞳神缩小 肝肾阴虚善怒 肺阴虚咳嗽 肾阴虚火旺牙龈肿痛 血虚阴亏手足心热 肝肾亏虚痴呆 阴虚火旺小便挟精 肾阴虚耳聋 阴虚动风啮齿 阴虚痰阻哮鸣 心阴亏虚不寐 肾阴亏虚尿浊 肾阴欲竭舌光 肝肾阴虚目昏 痰气交阻乳房肿块 阴虚火旺发癍
血精	阴虚火旺血精 下焦湿热血精
瞳神干缺	肝胆郁热瞳神干缺 肝肾阴虚瞳神干缺
产后小便难	血瘀产后小便难 肾气虚产后小便难 气滞产后小便难 气虚产后小便难
拳毛倒睫	风热内积倒睫 肺脾气虚倒睫
鼻衄	胃火炽盛鼻衄 肝肾阴虚腹露青筋 肾阴虚损鼻衄 阴竭阳脱鼻衄 阴虚火旺汗血 血热动血汗血 痰热阻肺顿咳 脾不统血鼻紐 阴虚血热紫癜 风热壅肺鼻衄 瘟毒发黄 褒血内阻朱砂掌 风寒欲解鼻衄 肝火犯肺鼻衄
口唇颤动	胃火挟风口唇颤动 脾虚血燥口唇颤动
经行搭瘺	风热经行痞瘍 血虚经行搭瘺
小儿五硬	血挤五硬 胎寒五硬 风寒五硬
腋汗	肝胆湿热腋汗 肝热阴虚腋汗
筋惕肉哺	阳虚水泛筋惕肉晡 阳虚筋惕肉哺
须发早白	肝肾亏拫须发早白 肝郁气滞须发早白 营血虚热須发早白
产后血崩	气虚产后血崩 血挤产后血崩
神昏	余毒上攻口颊攒烂 内闭外耽神昏 热毒炽盛大便失禁 毒热炽盛蝶形红斑 阴坶阳脱神昏 热盛动风神昏 热毒攻心神昏 暑邪上霣神昏 温热时毒颜面红肿 风热上攻目偏视 热炽营血壮热 热深厥深身热肢寒 阴虚风动神昏 热毒籩结腹部硬满 热毒内陷营血鼻肿 淤血乘心神昏 湿热阻滞面具脸 热入营血暴盲 疮毒内陷寒战 热入营血但热不寒 风疲内闭神昏 阳明腑实潮热 腑热熏蒸神昏 热陷心包舌卷 邪入血分发热 心火亢盛舌衄 热结肠道但热不寒 阳明捬实烦躁 热极或湿热生风四肢抽搐 热入心包舌强 湿热蒙蔽神昏 走马牙疳 胎毒菹结丹毒 肝风舌颤 热陷心包神昏 心火炽盛小便黄赤 阳盛实热舌红绛 邪毒炽盛闭肺内陷《陷逆证》 瘟毒发黄 血瘀产后眩晕 真热假寒恶寒 肝经气绝舌卷 余毒流注鼠溪肿痛 邪毒炽盛产后发疫 疫毒供灼气营丹痧
汗出偏沮	寒湿痹阻汗出偏沮 营卫不和汗出偏沮 气血亏虚汗出偏沮
身痛	风寒袭络半身麻木 风寒束表身痛 风寒束表背冷 外感风寒发热 瘀阻络脉身痛 湿阻膝原舌苔白腻 风寒束表四肢拘急 外邪干胃呕吐 风邪犯肺咳痰 湿著肌表身痛 风寒束表项强 时行疫毒咽喉白腐 毒热蕴滞丹毒 风寒产后发痉 风寒袭表恶寒发热 寒邪束表面色青 风邪犯表产后发热 气滞血褒善疑 血寒凝滞手足厥冷 风寒咽痛 风寒欲解鼻衄 风寒束表舌苔白
顔面抽搐	风邪袭络顔面抽描 肝血亏虚顔面抽搐 肝血郁结颜面抽搐 风痰入络颜面抽搐 肝风内动颜面抽搐
吐蚘	胃热吐蚘 胃寒吐蚘
颜面红肿	风热上扰颜面红肿 温热时毒颜面红肿 误食中毒顔面红肿
舌苔黄	风热痰盛口颊澳烂 肺火上炎鱼胞 脾胃积热流涎 湿热熏蒸头汗 痰火扰心心悸 脾胃湿热手足汗出 湿热发黄 心脾积热啮齿 酒积湿热反胃 温热时毒颜面红肿 胃火呃逆 湿热上犯视瞻昏渺 湿热结单腹胀大 胃热炽盛消瘦 暑湿袭表恶寒发热 湿热下注臁疮 热炽阳明自汗 酒毒内蕴白睛红赤 胃火炽盛舌疮 湿热侵淫痿废 肝经湿热阴茎溃烂 湿热阻痹骨痛 胃热恶心 湿热下注阴痒 肝胆湿热耳胀闷 肝郁血热腋窝红肿 心火炽盛舌纵 脾胃积热多汗 肝经实热目畏热 热入营血红疹 湿热壅遏眼睑丹毒 湿热蕴积黄汗 脾胃积热目畏热 胃肠实热舌苔黄 湿热郁蒸但热不寒 阳明热结挤腹痛 肝胆湿热腋汗 热炽气分口渴 睥胃湿热呕吐 胃热炽盛舌苔黄 痰热蕴肺口臭 痰阻舌麻 伤食腹泻 湿热蕴结四肢肿胀 胃热呕吐 署湿吐泻 湿热阻滞下肢生疽 湿热蘊结肛裂 拖接初期恶寒 湿热阻络红斑 胃肠湿热蕴毒便血 湿热雄结便难 湿热郁阻白痏 胃肠实热政满 下焦湿热血精 脾经湿热鼻痒 湿热龜结研腹痛 脾肺积热赤膜下垂 风湿夹热瞳神缩小 湿热郁蒸鼻肿 署湿籩结肩背痈肿 肝火上炎舌衄 胃热嘈杂 毒热炽盛水痘 肝胆湿热胁痛 湿热腹泻 热结旁流腹泻 肺热津伤瘘废 风热湿毒耳痒 脾经湿热失嗅 肺胃热盛鼻痛 痰热阻肺顿咳 湿热郁结痰核流注 燥火内结肛裂 胃肠湿热大便胺血 胃火挟风口唇颤动 热毒壅盛鼠蹊肿痛 肝胆湿热耳内流脓 湿热阻瘅摊疾 湿热阴挺 热结肠道但热不寒 饮食积滞吞酸 痰浊阻肺口唇青紫 胃热吐蚘 阳明腑实产后大便难 余毒流注鼠溪肿痛 湿热里急后重 表寒里热气喘 胃火燔龈牙痛 湿热壅滞舌苔黄 风热挟湿红疹 痰火扰心妄听妄视 湿热蕴结缺盆溃烂 肝胆湿热阴疮 疫留气分欲解战汗 火毒凝滞腋窝红肿 津气亏虚白痏 热重于湿阴肿 肝经湿热女阴白斑 脾胃湿热胬肉 寒热错杂哮鸣 湿热下注胫痠 湿热郁蒸心中懊侬 湿热蕴蒸头重 胎毒菹结丹毒 毒热炽盛丹毒 脾胃湿热脐漏 热盛动风啮齿 痰火口唇红肿 靑腿牙疳 湿热内苔皮肤褐斑
善疑	心脾两虚善疑 阴虚阳亢善疑 心胆不宁善疑 肝气郁结肛门重坠 胆热痰扰善疑 肝郁血虚善疑 气滞血褒善疑
嗳气	肝脾不和肠鸣 食积胃肠口酸 食滞吐泻 伤食积滞脐腹痛 脾虚夹湿睑弦赤烂 肝郁气滞皮肤褐斑 脾胃气虚暧气 肝气上逆咽中异物感 阳气郁阻手足厥冷 睥虚肝乘口酸 食滞胃肠嗳气 血嵌乳汁不行 脾运失健厌食 肝气犯胃暧气 气滞血疲蝶形红斑 肝郁血虚瘫痪 气滞湿阻单腹胀大 肝郁气滞视瞻昏渺 肝郁脾虚腹泻 肝热妊娠呕吐 气滞腹痛
上胞下垂	风邪入络上胞下垂 气滞血淤上胞下垂 脾气下陷上胞下垂
寒战	疮毒内陷寒战 湿热阻滞下肢生疽 风热化火丹毒 拖接初期恶寒 寒邪直中舌紫 风寒束表啮齿 阳虚寒盛寒战 外寒内热寒战 毒入血分皮肤红线 疟疾寒战 火毒乳房红肿 真热假寒恶寒 寒邪外束寒战 战汗寒战 湿热阻滞面具脸
乳房肿块	肝气郁结乳房肿块 气滞血瘀乳房肿块 痰气交阻乳房肿块
头目胀痛	肝阳上亢面色红 痰湿上逆头目胀痛 肝胆火旺善怒 阴虚火旺头目胀痛 风热壅盛胞内生肉 肝火犯胃头目胀痛 肝阳上亢头目胀痈
舌紫	气滞血疲经行浮肿 气滞血瘀沩胎 寒邪直中舌紫 血分热毒舌紫 瘀血阻滞凄废 班血阻络面具脸 气滞血班腹中痞块 血疲经行身痛 心血瘀阻小儿心悸 瘀血阻滞月经过多 气滞血嵌经期延长 血褒腹痛 气滞血疲蝶形红斑 肩凝肩不举 肝肾阴虚舌蒌 心血瘀阻胸闷 瘀血阻络腿肿痛 褒血阻滞梦游 嵌血内阻舌紫 血瘀产后发热 心血瘀阻面色靑 气滞血班难产 酒毒内茧舌紫 挤血阻滞不射精 气滞血瘀胎死不下 瘀血内阻面色黧黑
眼皮跳	血虚生风眼皮跳 脾胃气虚眼皮跳 风热外侵眼皮眺
鼻塞	风寒束表咳嗽 风寒侵犯小儿音哑 风寒表实无汗 外感风热白睛红赤 外感风寒发热 脾经湿热失嗅 肺经郁热鼻塞 风热犯肺鼻痒 风寒束表恶寒 风热鼻塞 风湿犯头头重 风邪外袭口眼呙斜 气滞血瘀鼻塞 外感风寒经行发热 风邪袭络顔面抽描 邪留肺卫低热 风热犯肺咽肿 风寒鼻塞 肺气虚寒喷嚏 风寒束表面色白 风热袭肺咽干 风寒羞明 风邪犯肺咳痰 肺脾气虚鼻塞 外感风热水痘 湿热鼻流涕 表寒里热无汗 风寒目痒 胆腑郁热失嗅 风寒腹泻 风热上扰耳内流脓 肾阳虚喷嚏 风热袭肺耳聋 风热犯肺喷嚏 肝胆湿热鼻塞 肺脾两虚失嗅 肺肾阴虚鼻塞 风热侵犯小儿音哑 风热犯肺耳胀闷 风寒妊娠咳嗽 风寒咽痛 风寒袭肺耳胀闷 肺气虚鼻痒 脾气虚弱喷嚏 风寒束表身痛 血淤阻肺失嗅 痰火阻肺鼻痠 麻毒时邪由里出表〔初热期〉 风热壅肺鼻痠 外感风温发热 风寒喉痒 风寒袭肺喷嚏 风寒袭表恶寒发热 外感风寒经行身痛 风热袭肺咳瞅 风寒湿邪壅滞鼻痛 湿热郁蒸鼻肿 肺经风热失嗅 肝胆湿热鼻臭 肺气失宣鼾眠 风寒妊娠音哑
善喜	心火炽盛善喜 疲火扰心善喜 气虚血疲善喜 水火不济善喜 肝郁火旺善喜
产后浮肿	气血两虚产后浮肿 脾阳虚产后浮肿 气滞血褒产后浮肿 肾阳虚产后浮肿 湿热下注产后浮肿
唇肿	风热化火丹毒 风湿唇肿 气滞血疲唇肿 风热唇肿
身重	湿热下注月经过多 风寒侵犯小儿音哑 水湿困脾浮肿 湿热郁蒸但热不寒 脾胃湿热手足汗出 外邪干胃呕吐 外感寒湿舌苔白腻 肝胆湿热腋汗 风湿犯头头重 湿毒鼉结膝肿痛 湿热蕴结壮热 睥阳不振浮肿 风湿挟热肛门瘙痒 阳虚水泛身重 湿郁低热 水饮内停口渴 痰湿上逆头目胀痛 湿著肌表身重 湿热遂阻肛门流脓 痰饮中阻舌答灰黑 气滞胎位不正 肾阳虚衰嗜睡 湿热下注产后浮肿 风痰郁结痰核流注 湿热雄结便难 心火脾湿夭疱疮 风水相搏身重 湿热内苔皮肤褐斑 风湿夹热瞳神缩小 湿热獲结肛门生痔 脾虚湿因疲乏
皮肤脱屑	血虚风燥手足脱屑 血热风煉脱屑 风湿蕴肤脱屑 血虚皮肤瘙痒 肺胃明伤余热丹痧 血虚风煉脱屑 风热外袭脱屑 毒热炽盛脱屑
发癍	热入营血发癍 脾不统血发癍 风湿热郁发癍 气滞血瘀发癍 阳气虚发癍 阴虚火旺发癍
阴吹	气郁阴吹 胃燥津亏阴吹 气虚阴吹 痰湿阴吹
腹满	胃肠实热舌苔黄 水饮内停口渴 湿热瑰结腹满 脾阳虚衰舌苔灰黑 脾胃虚寒黄液上冲 热结肠道但热不寒 食滞胃脎腹满 阳明腑实谵语 邪热伤津项强 脾虚舌胖 阳明热盛发狂 胃火燔齿牙齿焦黑 湿阻气滞胎死不下 胃热干呕 胃肠实热政满 脾阳虚衰舌苔白 胃肠实热小便黄赤 湿毒鼉结膝肿痛 阳虚津不上承舌干 阳明瞄实发热 寒湿中阻腹满 血丧胞衣不下
胚周痈肿	寒邪凝滞胚周痈肿 虚热结聚胚周痈肿 实热费积胚周痈肿
喜食异物	情志异常喜食异物 疳积喜食异物 虫积喜食异物
乳房红肿	气郁乳房红肿 火毒乳房红肿 血褒乳房红肿 乳积乳房红肿
妊娠呕吐	痰滞妊娠呕吐 胃寒妊娠呕吐 胃气虚妊娠呕吐 肝热妊娠呕吐 胃热妊娠呕吐
耳内流脓	风热上扰耳内流脓 脾虚湿困耳内流脓 肾元亏损耳内流旅 肝胆湿热耳内流脓
目痒	火盛目痒 脾虚湿滞胞睑肿胀 风寒目痒 血虚目痒 风热目痒
舌光	瘀血阻络紫癜 气阴两虚舌光 胃阴干涸舌光 热入营分谵语 肾阴虚产后小便频数与失禁 气血两虚舌光 肾阴欲竭舌光 阴虚火旺发癍
疳翳	脾虚气陷疳翳 伤食积滞疳翳 虫积疳翳 睥虚湿困疳翳 脾肾阳虚疳翳
面诟	肝肾阴虚面诟 胃热熏蒸面诟 暑湿蕴蒸面诟 燥干清窍面诟
发癫	肝郁气滞发癫 心脾两虚发癫 气虚痰结发癫 痰蒙淹窍发癫
丹毒	风热化火丹毒 热毒攻心神昏 湿热化火丹毒 肝胆湿热丹毒 胎热丹毒（俗称游火）
大便下血	肝肾阴虚便血 脾不统血经行便血 胃肠湿热蕴毒便血 脾肾阳虚便血 风火熏迫大扬便血 宵肠积热经行便血
胬肉攀睛	脾胃湿热胬肉 肺经蕴热胬肉 肝经火盛胬肉 肾经虚火胬肉 术后屡发胬肉 心火炽盛胬肉
大便秘结	肝经湿热阴冷 心经积热啼哭 肺火上炎鱼胞 气郁低热 相火偏旺性早熟 阳明腑实谵语 心脾实热弄舌 血热胎动不安 燥火内结肛裂 肝肾实火阴茎溃烂 胃火炽盛妊娠消渴 胃热干呕 胃实热吐血 胃肠湿热蛔虫扰动症 肺气壅滞小便不通 热毒籩结腹部硬满 乳食不节积滞 脾胃湿热面部脱屑 胃火燔龈牙龈蒌缩 湿热腰膝无力 风热上扰颜面红肿 湿热阴挺 胃火炽盛舌疮 心阴亏虚小儿心悸 肠道热结壮热 阴虚火旺口唇焦裂 阴虚风动小儿抽动 肺胃热盛乳娥 肺胃蕴热小儿音哑 血瘀气滞尾闾痛 胃肠积热粉刺 血虚阴亏便秘 风火熏迫大扬便血 胎毒发热 阳明腑实产后大便难 痰热闭肺鼾眠 脾胃积热多汗 实热肛门疼痛 阳明实热舌裂 胃肠实热小便黄赤 气阴两虚针眼 脾胃积热目畏热 胃火燔龈牙痛 肝脾气滞便秘 胃肠实热舌苔黄 胃火口唇红肿 热极肢厥手足厥冷 湿热蕴蒸颈后生痈 脏躁善悲 痰火上扰谵语 阳明热结挤腹痛 热盛动风神昏 疾热结胸舌苔黄腻 湿热内阻小便不利 血虚阴亏手足心热 热炽气分口渴 热毒湿注胚周疮毒 睥胃湿热呕吐 脾胃湿热胬肉 热毒炽盛针眼 阳明腑实心中懊侬 胃阴干涸舌光 气分热盛烦躁 脾胃热盛口唇焦裂 实火上炎口颊溃烂 实热费积胚周痈肿 脾胃积热口疮 疾火内扰烦躁 胃火炽盛善食易饥 胃火炽盛鼻衄 阳明腑实潮热 热毒炽盛脓疱 肝经湿热阴痛 肺胃热盛红鼻 拖接初期恶寒 胃火牙銀肿痛 心脾积热舌肿 实热便血 肺火背热 心脾积热银口 食滞宵肠啮齿 脾肺气虚便秘 阳明热盛发狂 胃旸实热肥胖 胃肠实热便秘 脾肾阳虚便秘 时发时止大便脓血 膀胱湿热尿频 胃肠实热政满 热毒蕴结尿脓 实热肛漏
指甲变异	肝郁血虚指甲变异 气血两虚指甲变异 血瘀指甲变异 风湿指甲变异 脾胃不足指甲变异
胎位不正	气血两虚胎位不正 气滞胎位不正
小便浑浊	脾肾两虚尿浊 下焦血瘀尿痛 肾阴亏虚尿浊 肾阴亏虚尿痛 肾阳虚衰尿浊 脾虚气陷尿浊 下焦湿热尿痛 下焦湿热尿浊
面色熏黑	肾精亏虚面色黧黑 肾阳虚面色熏黑 瘀血内阻面色黧黑
皮肤癍痕	湿热苔结癍痕 瘀血阻滞癍痕
尿脓	阴虚火旺尿脓 热毒蕴结尿脓
身振摇	阳虚身振摇 肝风内动身振摇
肥胖	疲油中阻肥胖 痰湿经行头痛 痰湿下流阴冷 脾肾阳虚肥胖 痰浊凝滞沩胎 疲疲互结把胖 痰湿中阻食后困顿 湿热内蕴脓疱 胃旸实热肥胖 痰湿阻滞闭经 痰气郁结乳房胀痛 痰湿中阻肥胖 气虚肥胖
关节变形	痰瘀辨阻关节变形 气血亏虚四肤疼痛 气滞血挤关节变形 肝肾亏虚关节变形
小儿多动	痰火扰心小儿多动 心脾气虚小儿多动 肾虚肝旺小儿多动
舌苔白	痰湿中阻食后困顿 寒邪阻络四肢疼痛 肺经风热鱼胞 暑湿流注鼠蹊肿痛 脾胃虚弱积滞 寒滞肝脉少旗痛 邪伏募原恶寒 寒饮内停偏头痛 睥虚湿困疳翳 风邪闭阻四肢抽搐 痰浊阻滞胸痛 寒湿中阻腹满 肝肾两亏流泪 风寒束表舌苔白 痰浊内阻手足厥冷 寒凝妊娠下肢抽筋 风湿皮肤瘙痒 痰迷心窍舌不知味 寒疲阻肺哮鸣 寒湿侵袭背痛 寒湿腰膝无力 营卫不和汗出偏沮 湿痰阻窍痴呆 肝气乘脾目札 疾气互结反胃 营卫壅闭黄汗 风痰经行抽搐 痰湿咳嗽 寒湿大便脓血 肾阳虚喷嚏 外邪干胃呕吐 肾虚痰阻气喘 寒湿痹阻汗出偏沮 睥虚肝乘口酸 痰湿白带 风痰挟瘀四肢抽搐 脾阳虚衰舌苔白 湿热蕴蒸云雾移睛 痰阻舌麻 痰湿内阻言语错乱 风中经络半身不遂 脾虚湿蕴指（趾）缝湿烂 寒湿腰重 风寒湿凝滞下肢生疽 风湿客表恶寒发热 风痰上扰啮舌 湿阻膝原舌苔白腻 风疲入络口眼呙斜 过食生冷积滞 中外风舌歪 痰湿阻滞闭经 痰湿内阻头晕 邪入少阳胁痛 痰饮内伏背冷 湿热白庀 水湿困脾浮肿 疲蒙清窍痴呆 寒邪犯胃胃痛 风湿犯头头痛 脾虚湿热鼻臭 湿著肌表身痛 脾肾阳虚便难 太阳伤寒头冷 寒湿袭表舌苔白 风寒表证口噤 气滞湿阻腹露青筋 湿困脾胃口淡 寒滞肝脉腹冷 寒湿发黄 痰浊阻肺气喘 肝郁气滞憋气 湿困脾阳嗜睡 蝈虫啮齿 血热白庀 寒饮内停舌苔白腻 痰浊犯头头痛 痰湿阻滞麻木 风寒束肺胸闷 气滞血瘀乳房肿块 寒滞扬道面色青 痰湿阻络目偏视 肾虚风湿阴茎溃烂 风寒肩痛 中内风舌歪 肝气郁结失语 虚寒吐泻 气滞湿阻单腹胀大 风疲内闭神昏 寒湿内阻吞酸 麻毒时邪由里出表〔初热期〉 气虚痰结发癫 湿热蕴蒸头重 风寒外侵无名肿毒 脾虚舌胖 湿阻气滞头胀 风中经络流涎 风痰郁结痰核流注 风痰闭神痫 痰气痞 风痰入络手颤 寒湿束表无汗 痰壅气阻喉中痰鸣 湿毒浸淫指（趾）缝湿烂 风痰上扰目昏 风邪入侵四肤强直 寒湿吐泻
产后胁痛	血疲产后胁痛 血虚产后胁痛 气滞产后胁痛
脱发	褒血阻滞脱发 肾虚腰痠 阴虚齿燥牙齿浮动 血热生风脱发 风冷客经牙齿焦黑 湿热挟毒头白秃 气血两虚脱发 肾气不足精液清冷 肾阳虚腰重 肝肾虚腰膝无力 肾虚腰脊痛 阴血亏虚脱发
漏下	气血虚弱漏下 虚寒肛漏 气滞血瘀漏下 气血两虚麻木 脾不摄血紫斑 阴虚血热漏下 脾不统血红斑
胎毒	胎毐内藴杨梅疮 胎毒发寒 胎毒发黄 胎毒发热 胎毒发搐
皮肤粟疹	疾热阴虚粟疹 血热郁肤粟疹 风湿瘀阻粟疹 肺宵热盛粟疹 湿热壅滞粟疼 毒热浸淫粟疹
胚门重坠	湿热下注胚门重坠 气滞血瘀肛门重坠 肝气郁结肛门重坠 中气下陷肛门重坠
红鼻	血热红鼻 气滞血瘀红鼻 肺胃热盛红鼻 毒热蓬结红鼻
善忧思	心脾气结善忧思 肺气不足善忧思
失语	肝气郁结失语 疲蒙清窍痴呆 肾精不足失语
小儿丹毒	毒热蕴滞丹毒 胎毒菹结丹毒 毒热炽盛丹毒
痴呆	痰气郁结妄听妄视 湿痰阻窍痴呆 痰迷心窍舌不知味 肝肾亏虚痴呆 髓海不足痴呆 气郁血虚痴呆 痰蒙淹窍发癫
经行先后无定期	肝郁肾虚经行先后无定斯 肝郁肾虚经行先后无定期 肝郁化火经行吐衄 心脾虚弱经行先后无定期
头皮脱屑	血热化燥头皮脱屑 毒邪浸淫头皮脱屑 风热化燥头皮脱屑 湿热生风头皮脱屑
经行头痛	肝阳上亢经行头痛 痰湿经行头痛 血疲经行头痛 血虚经行头痛
胚周疮毒	热毒湿注胚周疮毒 肺脾肾虚肛周疮毒
目昏	脾气虚弱目昏 痰气痞 肝肾阴虚目昏 肝阴虚胁痛 心肝血虚目昏 肝肾阴虚瘫痪 风痰上扰目昏 肝肾两亏流泪 肝郁气滞目昏 命门火衰目昏 肝肾亏虚近视 肝胆湿热鼻塞
噎膈	阴虚津亏噎膈 痰气互结噎膈 气虚阳微噎膈 瘀血内阻噎膈 胃阴干涸舌光
体臭	湿热蛮蒸体臭 胎毒内遼体臭
肛门瘙痒	风热郁结肛门瘙痒 风湿挟热肛门瘙痒 血虚生风肛门瘙痒
月经过少	血瘀月经过少 月经过少 脾胃虚弱月经过少 血虚月经过少 肾气虚月经过少
眼睑丹毒	风热相搏眼睑丹毒 湿热壅遏眼睑丹毒
经行发热	外感风寒经行发热 外感风热经行发热 肝郁化火经行发热 气血两虚经行发热 阴虚火旺经行发热 胞宫瘀血经行发热
人工流产术后阴道异常出血	褒阻胞宫阴道异常出血 湿热壅滞阴道异常出血 气血两虚阴道异常出血
皮肤萎缩	寒凝血疲萎缩 气血两虚萎缩 肝肾阴虚萎缩 毒邪浸淫萎缩
鼻肿	热毒内陷营血鼻肿 湿热郁蒸鼻肿 热毒壅肺鼻肿 疳热攻肺鼻肿
小儿痴呆	髄亏痴呆 肝肾亏虚痴呆 疲蒙清窍痴呆 心血亏虚痴呆 瘀阻脑络痴呆
小儿肥胖	疲油中阻肥胖 脾肾阳虚肥胖 疲疲互结把胖 肺气虚肥胖 胃旸实热肥胖
皮肤黑斑	挤血阻络皮肤黑斑 肝郁气滞皮肤黑斑 睥气虚皮肤黑斑 肾阴虚皮肤黑斑
产后腹痛	寒凝产后腹痛 血瘀产后瞄痛 血虚产后腹痛 血瘀产后腰痛
黄液上冲	脾胃实热黄液上冲 脾胃虚寒黄液上冲
嗜睡	疲油中阻肥胖 痰浊上蒙晕厥 痰湿下流阴冷 寒湿发黄 脾胃阳虚慢惊 肾阳虚衰嗜睡 脾气虚食后困顿 湿困脾阳嗜睡 肾精不足嗜睡 湿阻气滞胎死不下 胃气虚弱呕吐 瘀血阻窍嘈睡 痰湿内阻头晕 邪毒内陷心肝 心脾两虚嗜睡 疼毒外达肺部苔热《见形期〉 疲湿兼闭心窍半身不遂 肝肾阴虚舌蒌 外感暑邪发热 一、湿热初侵，邪犯肺胃
吞酸	寒湿内阻吞酸 饮食积滞吞酸 食积腹泻 肝气犯胃经行呕吐 食积腹痛 肝胃不和嘈杂 肝气犯胃吞酸 胃热恶心 伤食恶心 过食生冷积滞 气滞湿阻小便不利 宿食积滞舌腐 肝气郁结小便不通 伤食嘈杂 肝郁脾虚腹泻 乳食不节积滞 痰气郁结乳房胀痛 胃热嘈杂 胃热呕吐
瘫痪	肾阳虚摊痕 瘀血阻络瘫痪 脾胃气虚瘫痪 肺胃津亏瘫痪 三、邪去正虚，肝肾亏损 肝肾阴虚瘫痪 肝郁血虚瘫痪 瘀血攻心健忘 寒湿阻滞雜疾 二、湿热阻络，气虚血瘀 湿热阻瘅摊疾
赤脉传睛	阴虚火旺赤脉传睛 阴精亏拫赤脉传睛 心火赤脉传睛
绝汗	气明欲脱绝汗 阳气欲脱绝汗
小儿啼哭	伤食积滞啼哭 心经积热啼哭 受惊恐惧啼哭 胎热小儿脐突 心虚禀弱啼哭 眙禀亏虚小儿脐突 脾经虚寒啼哭
发黄	肝胆湿热舌苔黄腻 寒湿发黄 湿热熏蒸头汗 湿热蒙蔽谵语 脾虚血亏发黄 湿热郁蒸心中懊侬 胃肠湿热蕴毒便血 湿热蒙蔽神昏 湿热发黄 嵌血发黄 肝胆湿热小便黄赤 肝胆湿热尿血 瘟毒发黄 肝胆湿热妊娠疫痒 寒湿中阻腹满
发狂	热入营血但热不寒 邪入血分发热 肝胆郁火发狂 阴虚火旺发狂 肝郁气滞经行情志异常 热入营血烦躁 痰火上扰发狂 阳明热盛发狂 瘀血内阻发狂
浮肿	脾阳虚产后浮肿 水湿困脾浮肿 气虚黄带 肺气虚弱颜面浮肿 脾胃虚弱月经过少 风水相搏浮肿 肝肾亏虚四肢疼痛 风热犯肺浮肿 脾肾不足煤形红斑 气滞肌表四肢肿胀 肾阳虚浮肿 脾阳虚浮肿 寒湿腰冷 肾阳虚产后浮肿 水饮内停口渴 水饮凌心小儿心悸 脾气虚白带 腑肾阳虚食欲不振 阴虚肝旺妊娠痉厥 阳虚面色白 阳虚舌边齿痕 气滞胎位不正 肾阳虚衰嗜睡 肺气失宣小便不利 胎毒发热 痰湿阻滞不孕 湿热下注产后浮肿 脾不统血红斑 心脾两虚脑鸣 脾气虚弱交接出血 气血两虚产后浮肿 肝肾亏虚关节疼痛 睥虚湿泛妊振肿胀 脾气虚弱经行泄泻 脾肾阳虚经断前后诸症 脾肾阳虚单腹胀大 脾阳不足颜面浮肿 肾阳虚咳嗽 湿热壅盛泮肿 睥阳不振浮肿 肾阳虚妊娠小便不通 阳虚水泛身重 风寒袭肺浮肿 气血两虚浮肿 湿热阻络红斑 肾阳虚产后小便频数与失禁 脾虚寒湿舌淡白 脾气亏虚胎水肿满 脾虚湿滞胞睑肿胀 痰湿阻滞闭经 湿阻气滞胎死不下 靑腿牙疳 风水相搏身重 心阳虚心下悸 脾肾阳虚经行浮肿 脾气虚弱经断复行 阳虚津不上承舌干 痰饮内伏背冷
颈粗	心肝阴虚颈粗 气血褒结颈粗 痰气郁结颈粗
产后乳汁自漏	肝热产后乳汁自漏 肝郁产后乳汁自漏 气虚产后乳汁自漏
目畏热	风热目畏热 肝经实热目畏热 脾胃积热目畏热
胁痛	肝胆湿热胁痛 膀胱阻滞小腹痛 肝阳上扰头痛 肝胆湿热尿频 肝郁气滞呵欠 肝阴虚胁痛 肝胃不和恶心 肝郁气滞目珠自胀 肝郁气滞经行腹痛 肺燥津亏口渴 肝胆湿热丹毒 疲饮内阻胁痛 肝阳上亢经行头痛 肝火上炎头热 肝火犯胃吐血 肝经火盛胬肉 瘀血阻络胁痛 肝气郁滞胸闷 肝肾阴虚经断前后诸症 肝郁气滞胁痛 肝阳上扰偏头痛 气滞血疲闭经 肝火上逆暴盲 气郁乳房红肿 肝火犯肺咳嗽 肝胃不和呕吐 肝气郁结肛门重坠 气血褒结颈粗 邪入少阳胁痛 湿热蕴积黄汗 肝热妊娠呕吐
颈后生痈	气血亏虚颈后生痈 阴虚火毒颈后生痈 湿热蕴蒸颈后生痈
目干涩	阴虚火旺赤脉传睛 血虚生风眼皮跳 肝肾阴虚阴疮 阴血亏虚目干涩 肝肾亏损云雾移睛 阴精亏拫赤脉传睛 肝肾阴虚瞳神干缺 心肝血虚目昏 肝血不足夜盲 燥热伤津目干涩 血虚神闭痫 肝肾阴虚阴痛 肝肾阴虚目昏 津液亏虚甲错 肝肾阴虚月经过多
四肢抽搐	阴虚阳亢生风四肢抽搐 中毒所致四肢抽搐 热极或湿热生风四肢抽搐 脾肾阳虚四肢抽搐 肝郁血虚四肢抽擄 血虚产后发痉 痰火扰神痫 痫证弄舌 血虚生风四肢抽搐 风痰挟瘀四肢抽搐 气郁痰壅口噤 风寒产后发痉 寒湿阻络角弓反张 外伤风毒口噤 热入营分谵语 热毒内陷营血鼻肿 风邪闭阻四肢抽搐
经断复行	肝肾阴虚经断复行 肝郁化火经断复行 脾气虚弱经断复行 湿毒下注经断复行
胞睑肿胀	脾虚湿滞胞睑肿胀 被物所伤血灌瞳神 肺脾积热胞睑肿胀 早期眼胞疲痛
舌疮	胃火炽盛舌疮 肾阳虚舌疮 肾阴虚舌疮 肾阴虚尿频 血虚燥热舌搭 睥气虚夹热舌疮 心火上炎舌疮
战汗	疫留气分欲解战汗 太阳伤寒欲解战汗
白内障	阴虚白内障 脾虚白内障 胎患白内障 惊震白内障 火盛白内障
尾闾痛	肾气亏虚尾闾痛 血瘀气滞尾闾痛
不射精	挤血阻滞不射精 阴虚火旺不射精
阴茎溃烂	肝肾实火阴茎溃烂 肝经湿热阴茎溃烂 肾虚风湿阴茎溃烂 肝肾虚热阴茎溃烂
四肢瘦剖	肾精亏虚四肢瘦削 肝肾阴虚四肢瘦削 气血两虚四肤瘦削 脾胃虚弱四肢瘦剖 脾肾阳虚四肢瘦削
妊娠瘙痒	血虚风燥妊娠瘙痒 肝胆湿热妊娠疫痒
头皮疖肿	湿热头皮疖肿 暑毒头皮疖肿
经行腰痛	血虚气滞经行腰痛 肝肾亏损经行腰痛
痰核流注	风痰郁结痰核流注 湿热郁结痰核流注 脾虚痰湿痰核流注
口咸	肾阴虚证口咸 肾阳虚证口咸
妇人腹痛	气滞血瘀妇人腹痛 血虚失荣妇人腹痛 湿热瘀结妇人腹痛 热毒壅盛妇人腹痛 肾阳虚衰妇人腹痛 寒湿凝滞妇人腹痛
小儿异嗜	情志异常异嗜 热毒蕴肠异嗜 诸虫积滞异嗜 脾胃虚寒异嗜
足颤	肝肾不足小儿靑盲 阴虚动风啮齿 风寒湿侵足颤 血虚风动足颤
呵欠	肝郁气滞呵欠 脾肾阳虚呵欠 疟疾寒战 心肾不交脏躁 气滞血疲呵欠
瘫瘕	血瘀瘫瘕 痰湿癥瘕
颈项痛	风湿犯表颈项痛 风热挟疾颈项痛 落枕颈项痛 扭伤颈項痛
妊娠痉厥	脾虚肝旺妊娠疫厥 阴虚肝旺妊娠痉厥
心下痞	痰气痞 寒热痞 饮气痞 胃热干呕 客气上逆痞 胃寒干呕 热痞
初生目赤烂	火毒攻目目赤烂 肺脾积热目赤烂
沩胎	寒湿凝滞伪胎 气滞血瘀沩胎 痰浊凝滞沩胎 气血两虚沩胎
急惊	痰热惊风 暑热惊风 食滞惊风 外感惊风 脾胃阴虚痞块 惊恐惊风
转筋	气血不足转筋 热霍乱转筋 肝肾不足转筋 寒霍乱转筋 风寒外袭转筋
毛发脱落	疠毒攻肺毛发脱落 肾阳虚摊痕 气血两虚毛发脱落 肝肾阴虚毛发脱落 脾肾拓虚毛发脱落 风湿疠气麻木
小儿音哑	风热侵犯小儿音哑 风寒侵犯小儿音哑 肺胃蕴热小儿音哑 肺肾阴虚小儿音哑
瞳神散大	肝经风热小儿青盲 气阴两虚瞳神散大 肝气郁结艟神散大 肝火犯胃头目胀痛 阴虚火旺瞳神散大 痰火郁结瞳神散大 外伤瞳神散大
舌痒	心火炽盛舌痒 心肾阴虚受风舌痒
小儿发热	邪入血分发热 外感风温发热 外感风寒发热 邪入营分发热 阳明瞄实发热 外感暑邪发热
耳胀闷	肝肾阴虚耳胀闷 风热犯肺耳胀闷 脾气虚弱耳胀闷 气滞血褒耳胀闷 肾阳亏虚耳胀闷 肝胆湿热耳胀闷 风寒袭肺耳胀闷
脐内出血	血热妄行脐内出血 肾火偏亢脐内出血
夜盲	肝肾阴虚夜盲 气血两虚夜盲 脾虚失调囟门不合 脾肾阳虚夜盲 睥虚湿困疳翳 肝血不足夜盲 肾阳虚夜盲 脾气虚弱夜盲
舌生芒刺	营分热盛舌生芒刺 阳明腑实舌生芒刺
心悸	阴虚火旺暴盲 热灼肾阴舌苔灰黑 肾精亏虚下肢生疽:多发于儿童及靑年 阴虚火旺皮肤褐斑 痰火扰心心悸 痰湿阻络舌蒌 痰火扰心梦游 肝血不足夜盲 心肾阳衰面色青 心脾虚弱经行先后无定期 阴虚阳亢妊娠眩晕 气滞血疲呵欠 心气亏虚胸痛 痰湿阴吹 心胆气虚多梦 水火不济善喜 血虚月经过少 阴虚血亏便难 气血两虚善恐 气血两虚脱形 脾虚血亏发黄 阳气虚发癍 血热扰神心烦 心脾气虚心胸汗出 心脾两虚脑鸣 胸供肩不举 心气虚少气 心阴虚火旺心烦 气血两虚夜盲 心肾不交经断前后诸症 气滞血瘀口唇靑紫 心血亏虚小儿心悸 虚热赤白带 心气虚心悸 心血不足盗汗 血虚舌颤 脾气虚妊娠小便不通 气血两虚便血 血虚产后发热 气血两虚妊娠眩晕 气血两虚云雾移睛 气血两虚舌淡白 气血两虚经行发热 血虚皮肤瘙痒 心血虚心悸 气血两虚远视 心脾两虚舌蒌 痰火内扰妊娠心烦 肾阴虚损鼻衄 血虚风燥妊娠瘙痒 心血挤阻胸痛 血虚胎漏 营血虚热須发早白 心血褒阻心悸 气血两虚妄听妄视 心脾两虚嗜睡 脾肺气虚咳血 阳虚水泛气喘 血虚产后眩晕 阴虚血亏潮热 气血两虚动风角弓反张 心阴虚心悸 血虚晕厥 肝阳上亢面色红 阴虚血搡反胃 心气虚掼憋气 血不荣润腹筋挛急 心肾阴虚心胸汗出 血虚头皮麻木 气血两虚舌光 肾虚水泛妊娠肿胀 褒血犯头偏头痛 心气亏虚梦游 气血两虚胞衣先破 心肺气虚善悲 血虚面色白 气血两虚妊娠头痛 气血虚弱乳房胀痛 寒饮内停反胃 气血虚弱闭经 心气虚独语 精血亏虚脱形 气血两虚大便变形 气血两虚阴道异常出血 血虚妊娠下放抽筋 热毒侵及小儿心样 褒血阻滞梦游 阴虚火旺烦躁 水饮凌心小儿心悸 心阴亏虚小儿心悸 气血两虚老花眼 惊恐伤神心悸 血虚失荣妇人腹痛 阴虚肝旺妊娠痉厥 血虚风燥皮肤肥厚 心肾不交脏躁 水气凌心心悸 气虚下陷大便失禁 心脾两虚经断前后诸症 气血虚弱消瘦 气血两虚疲乏 心肾不交梦游 痰湿阻滞不孕 心脾两虚视物变形 心脾两虚多梦 气血两虚产后浮肿 心肝阴虚颈粗 气血两虚脱发 气血亏虚目珠自胀 阴血亏虚目视无神 气虚齿动牙痛 血虚经行眩晕 心血不足烦躁 心阳亏虚小儿心样 气阴两虚反胃 痰火扰心妄听妄视 瘀阻肺络咳血 心肾不交耳聋 心脾气血两虚头晕 肾阳虚衰小便不利 血两虚过期不产 津气亏虚白痏 心脾两虚经前不寐 血虚神闭痫 脾不统血鼻紐 阴虚火旺头目胀痛 心阳虚阴盛心烦 心血瘀阻胸闷 脾胃气虚瘦废 虚热胎漏 心阳虚心悸 脾肾阳虚胎水肿满 心阴亏虚不寐 气血两虚浮肿 气血两虚流产后闭经 脾肾阳虚经行浮肿
舌痛	阴虚火旺舌痛 脏腑实热舌痛
咽干	肺阴虚喉痒 胃阴虚呕吐 脾胃实热黄液上冲 阴虚血热经期延长 肝胆火旺善怒 热灼肾阴舌苔灰黑 肝郁化火经间期出血 肾阴虚证口咸 毒热炽盛肌肤疼痛 痰火扰心心悸 痰火扰心梦游 燥热伤肺咽干 真热假寒面色白 肝经湿热性早熟 心肾不交多梦 阴虚火旺经行口糜 阴精不足远视 肾阴虚喷嚏 肝郁化火闭经溢乳 肝肾阴虚耳胀闷 肝胆实火蟹睛 热入血室经来骤止 肝经湿热阴茎溃烂 气阴两虚舌光 膀胱湿热尿血 风湿热痹阻蝶形红斑 肝气郁滞胸闷 肾火偏亢脐内出血 胃热炽盛鼻干 血虚阴亏便秘 肝胆湿热耳胀闷 心肝火旺经前不寐 肝郁化火妊娠消渴 肺燥喉痒 气滞湿阻小便不利 肺胃阴虚低热 肺阴虚消瘦 气阴两虚瞳神散大 肝经实热目畏热 胆腑郁热失嗅 阴虚阳盛经间期出血 阴虚内热小便黄赤 阴虚肺燥经行吐衄 肝肾阴虚瘫痪 肺热壅盛咳血 肝郁气滞视瞻昏渺 气阴两虚咽痛 阴虚阳充脏燥 风热外袭脱屑 虚热赤白带 阴虚五心烦热 邪入少阳寒热往来 阴虚血热胎萎不长 肾虚腰痛 肝火耳聋 肝胃不和恶心 阴虚火旺咳血 肝郁气滞目珠自胀 肝胆热毒耳痛 肝胆湿热鼻塞 疲血阻滩反宵 风热犯肺耳胀闷 凉燥袭肺恶寒 邪郁少阳恶寒 肝肾虚热阴茎溃烂 肺经燥热鼻痒 肝胆湿热妊娠疫痒 肺热熏灼舌萎 虚火上炎口颊溃烂 燥热妊娠咳嗽 肝肾阴虚腹露青筋 膀胱湿热小便黄赤 阳明蓄血善食易饥 肺热咳嗽 肺肾气虚妊娠咳嗽 肺燥咳嗽 肝肾阴虚低热 肺阴虚咽干 胃燥津亏阴吹 肺胃津亏瘫痪 邪入少阳胁痛 肾阴亏虚尿痛 脾肺积热赤膜下垂 肝气郁滞脑鸣 肝火上炎舌衄 肝火犯肺鼻衄 心肾阴虚心胸汗出 肝胆火热血灌瞳神 肺胃热盛鼻痛 胃火燔齿牙齿焦黑 燥火内结肛裂 肝热产后乳汁自漏 阴虚火旺红斑 气阴两虚口淡 心火炽盛尿痛 肝胆湿热耳内流脓 虚火灼齿牙痛 阴虚火旺烦躁 肝郁化火经行发热 脾胃虚弱经行呕吐 肺热津伤消渴 风热袭肺咽干 肾阴亏损尿血 燥热伤肺白睛溢血 脾胃热盛咽干 邪入少阳口苦 血瘀低热 肺燥阴虚鼻干 风邪犯肺咳痰 血瘀痰聚声音嘶哑 虚热便血 肝胆郁热咽干 肾阴亏虚尿频 肾阴虚咽干 肝郁化火经行吐衄 风热上扰耳内流脓 肝胆湿热阴疮 虚阳浮越头热 火毒内侵悬雍下垂 阴虚肺燥咳痰 阴虚低热 肝肾阴虚瞳神缩小 肺阴虚咳嗽 肺肾阴虚鼻塞 肝胆火盛抱轮红 热盛伤津四肢拘急 阴虚动风啮齿 肝郁化火面痛 虚热胎漏 火盛白内障 阴虚痰阻哮鸣 心阴亏虚不寐 热入营血发癍 阴血亏虚目干涩 热毒炽盛脓疱 肝肾阴虚面诟 肝经湿热阴痛 虚阳浮越面色红 胆热痰扰善疑 表寒郁热烦躁 肾阴亏虚尿浊 肝气犯胃吞酸 痰热妊娠音哑 风热郁结肛门瘙痒 气阴两伤心中懊侬 热壅血瘀胸闷 风阳上扰头摇 湿热壅滞带状疱疹 燥热鼻流涕 胃阴亏虚妊娠消渴 燥邪伤肺咳嗽 心火亢盛尿血 肝阳上亢耳聋 肾阴虚妊娠音哑 肝胆火盛白睛红赤
皮肤皲裂	脾虚湿蕴皲裂 湿毒浸淫皲裂 血热风燥皲裂 血虚风燥皲裂
喉痒	风热喉痒 燥热妊娠咳嗽 肺肾阴虚声音嘶哑 肺阴虚喉痒 风寒束表咳嗽 风寒侵犯小儿音哑 风寒声音嘶哑 风寒表实无汗 风热外袭恶风 肺燥阴虚鼻干 肺燥喉痒 肺阴虚咽干 风寒喉痒 燥邪伤肺咳嗽 风寒妊娠咳嗽
肛门生疣	湿热下注 气滞血瘀 肝郁血虚 肝肾阴虚 风热郁毒
气从少腹上冲	气逆气从少腹上冲 水寒气从少腹上冲
胃痛	胃寒恶心 胃寒呕吐 胃阴虚胃痈 肝郁气滞胃痛 寒邪犯胃胃痛 寒饮内停偏头痛 脾胃虚寒胃痛 肝火犯胃宵痛 瘀阻胃络胃痛 食积胃痛
妊娠头痛	风寒妊娠头痛 风湿妊娠头痛 风热妊娠头痛 痰湿阻滞妊娠头痛 气血两虚妊娠头痛 肝阳上亢妊娠头痛
乳房胀痛	肝郁肾虚经行先后无定斯 肝经郁火经前面部粉刺 肝经郁热妊娠尿血 肝郁气滞不孕 气血虚弱乳房胀痛 气滞血瘀妇人腹痛 肝气郁结失语 肝热产后乳汁自漏 肝气郁结阴冷 肝郁化火经断复行 肝郁气滞乳房胀痛 肝郁化火经行吐衄 痰气郁结乳房胀痛
经间期出血	肝郁化火经间期出血 阴虚阳盛经间期出血 气滞血瘀经间期出血 湿热留滞经间期出血
胞衣先破	气滞血疲胞衣先玻 气血两虚胞衣先破
牙龈溃烂	风热牙疳 靑腿牙疳 走马牙疳
瘰疬	痰凝气滞瘰疬 肝肾阴虚瘰疬
产后大便难	血虚津亏产后大便难 脾肺气虚产后大便难 阳明腑实产后大便难
初生儿小便不通	热结膀胱小便不通 元气虚弱小便不通
皮肤红线	毒入血分皮肤红线 毒热郁滞皮肤红线 火毒炽盛皮肤红线
白睛溢血	风热犯肺白睛溢血 燥热伤肺白睛溢血 肝火上炎白睛溢血 撞击外伤白睛溢血 风寒袭肺白睛溢血 阴虚火旺白睛溢血
尿痛	下焦血瘀尿痛 膀胱湿热小便黄赤 膀胱湿热尿频 肾阴亏虚尿痛 心火炽盛尿痛 下焦湿热小便不通 下焦湿热尿痛 热毒蕴结尿脓
远视	阴阳两虚远视 阴虚火旺远视 气血两虚远视 阴精不足远视 气虚神伤近视 肝肾亏虚近视
小儿低热	湿热蘊结低热 邪留肺卫低热 食滞脾胃低热 气虛低热 阴虚低热 疳积低热
小儿五软	胎禀怯弱肾阳虚衰五软 后天失调脾气虚馁五软
头倾	脾气亏耗头倾 髓亏头倾
舌苔腐垢	宿食积滞舌腐 胃热痰浊上逆舌腐
手足汗出	脾胃阴虚手足汗出 脾胃湿热手足汗出 脾胃气虚手足汗出
小儿性早熟	肝经湿热性早熟 相火偏旺性早熟 脾虚痰湿性早熟 肝郁气滞性早熟
小儿腹痛	虚寒腹痛 食积腹痛 血褒腹痛 实热腹痛 寒凝腹痛 气滞腹痛
肢体瘘废	湿热侵淫痿废 肺热津伤瘘废 肝肾亏拫痿废 脾胃气虚瘦废 瘀血阻滞凄废
口颊溃烂	余毒上攻口颊攒烂 风热痰盛口颊澳烂 风寒肾虚口類浪烂 实火上炎口颊溃烂 虚火上炎口颊溃烂
足热	阴虚足热 热毒蕴结足热 风邪犯表足热
赤白带	湿热赤白带 虚热赤白带 虚寒赤白带 肝郁湿热赤白带
妊娠音哑	痰热妊娠音哑 肾阴虚妊娠音哑 风寒妊娠音哑 肺阴虚妊娠音哑
小儿抽动	脾虚肝亢小儿抽动 阴虚风动小儿抽动 肝风痰热小儿抽动
心烦	阴虚火旺暴盲 肝阴虚阳亢头晕 脾胃积热流涎 热灼肾阴舌苔灰黑 阴虚火旺皮肤褐斑 肾阴虚证口咸 相火偏旺性早熟 心脾积热啮齿 阴虚阳亢妊娠眩晕 阴虚火旺汗血 湿热妊娠尿痛 湿热赤白带 脾经伏热舔舌 胃热炽盛消瘦 胃热干呕 肝肾阴虚单腹胀大 痰热郁结脏躁 阴虚火旺心中懊侬 气阴两虚舌剥 肾阴虚喷嚏 肝郁化火闭经溢乳 心肾阴虚受风舌痒 毒热炽盛脱屑 心火亢盛舌衄 阴虚内热鱼胞 血热风煉脱屑 风邪外袭红斑 湿热下注阴痒 心肝火旺经前不寐 肺阴虚消瘦 肾阴亏损云翳 肝肾阴虚白睛红赤 肺肾阴虚咽肿 心火炽盛胬肉 血热风盛角弓反张 阴虚五心烦热 邪入少阳寒热往来 心血不足盗汗 肝阳化风半身不遂 肾虚腰痛 肝肾阴虚 胃热妊娠呕吐 肝肾阴虚阴痛 胃热炽盛舌苔黄 邪郁少阳恶寒 肝肾阴虚月经过多 肺燥津亏口渴 湿热蕴蒸云雾移睛 心血虚心悸 肝热阴虚腋汗 气滞妊娠小便不通 虚火上炎口颊溃烂 心脾积热口疮 血热染毒阴部水痕 肾阴虚损鼻衄 阳明病胃肠燥热心烦 肝肾阴亏崩中 风火燥结肛门生痔 肝肾阴虚便血 阳盛实热舌红绛 暑湿咳嗽 肺胃津亏瘫痪 虚热妊娠尿痛 邪入少阳胁痛 肝郁血虚 署湿籩结肩背痈肿 湿热内蕴指（趾）缝湿烂 肝火犯肺鼻衄 心火亢盛妊娠尿血 湿热腹泻 阴虚火旺吐血 肝胆火热血灌瞳神 阴虚火旺口疮 心火炽盛心烦 阴虚足热 阴血亏虚多汗 肝肾阴虚四肢瘦削 阴虚血燥面部脱屑 虫积反胃 肝热产后乳汁自漏 胃肠湿热蛔虫扰动症 或食脾胃损伤疳积 肝肾阴虚视物变形 相火偏旺滑胎 热痞 血热风燥红斑 肝肾阴虚小便失禁 阴虚风动小儿抽动 邪入少阳口苦 阴虚津亏木舌 心肾不交梦游 肝阳上扰偏头痛 肝气上逆咽中异物感 暑耗肺胄气阴疲乏 血虚肠煉肛裂 血热白庀 阴虚火旺心下悸 疲火扰心善喜 心血不足烦躁 脾阴虚口唇红肿 湿热壅滞舌苔黄 血热皮肤瘙痒 阴虚津亏产后小便淋痛 血热胎漏 肝郁阴虚经前乳胀 肝肾阴虚瞳神缩小 气虚神伤近视 肾阴虚火旺牙龈肿痛 邪伏阴分五心烦热 肺肾阴虚鼻塞 热伤气阴少气 肝郁化火面痛 火盛白内障 胃火炽盛鼻衄 热入营血发癍 血虚不荣红疹 肝火上炎头热 肝肾阴虚经断复行 胆热痰扰善疑 湿热郁蒸心中懊侬 肝气犯胃吞酸 肝肾阴虚毛发脱落 痰火扰神痫 湿热蕴蒸头重 肾阴不足头热 心火脾湿夭疱疮 痰气交阻乳房肿块 阴虚火旺发癍 肝郁气滞脏躁 阴虚血热经期延长 肝肾阴虚夜盲 湿热蕴蒸口渴 痰热藴脾口腻 火郁五心烦热 肝火上逆耳衄 阴虚内热舌红绛 肝阳化风四肢强直 水火不济善喜 血虚月经过少 阴虚火旺经行口糜 阴虚火旺妊娠心烦 肝阳上亢经行头痛 湿热蛮蒸体臭 虚火上炎重舌 气滞胎动不安 毒热炽盛杨梅疮 肝郁气滞须发早白 阴虚火旺妄听妄视 肾火偏亢脐内出血 气郁阻络手足紫绀 热毒灼营带状疱疹 血热扰神心烦 气阴两虚瞳神散大 心阴虚火旺心烦 肝肾亏虚四肢强直 肾经虚火胬肉 阴虚内热小便黄赤 心肾不交经断前后诸症 阴虚内热尿道溢脓 阴血亏虚口噤 阴虚阳充脏燥 阴虚阳亢生风四肢抽搐 阴虚火旺咽喉白腐 热极肢厥手足厥冷 痰火扰心善愤 阴虚火旺咳血 暑湿热郁心烦 心火上炎口苦 阴虚产后多汗 脾虚肝乘善怒 肺热熏灼舌萎 肝肾阴虚交接出血 肝肾阴虚瘰疬 肝肾阴虚腹露青筋 血热妄行紫斑 阴虚血热带环后阴道异常出血 气滞妊娠肿胀 肾阴虚崩漏 营血虚热須发早白 血热风燥头面瘙痒 肾虚肝旺小儿多动 阴虚血热不孕 阴虚血亏潮热 肝肾阴虚头昏 肝气郁滞脑鸣 气滞耻嵌耳聋 阴虚血热漏下 阴虚血搡反胃 肝胆湿热胁痛 心火亢盛产后小便淋痛 肝气犯胃经行呕吐 心火炽盛善喜 肺热津伤瘘废 阴虚津亏噎膈 燥火内结肛裂 阴虚火旺经前不寐 血热生风脱发 肾阴虚尿频 阴虚火旺红斑 肾精不足失语 肾虚腰脊痛 虚火灼齿牙痛 热毒蕴结膝肿痛 湿热阻瘠关节疼痛 湿热阴挺 肝郁化火经行发热 肝胆郁热口苦 肝经郁热妊娠尿血 肝肾阴虚经断前后诸症 脏腑实热舌痛 客气上逆痞 肾阴虚皮肤黑斑 阴虚火旺舌痛 虚热便血 肝肾阴虚阴部水疱 心肝阴虚颈粗 肝胆郁热咽干 疲热扰心不寐 阴虚内热面色红 肾阴亏虚尿频 邪入营分发热 表寒里热气喘 阴虚肝旺晕厥 痰火扰心妄听妄视 阴虚火旺视瞻昏渺 肾虚风湿阴茎溃烂 气阴两虚天疱疮 肝郁湿热赤白带 肝肾阴虚善怒 湿热内阻小便不利 血虚阴亏手足心热 心阳虚阴盛心烦 肾阴虚耳聋 寒热错杂哮鸣 阴虚动风啮齿 肝火偏亢月经过多 瘀血内结烦躁 肺胃热盛妊娠心腹胀满 疫毒内盛咽喉白腐 肝郁血虚手舞足蹈 阴血亏虚目干涩 肝肾阴虚面诟 肝火犯胃吐血 风热郁结肛门瘙痒 肾阴欲竭舌光 胃热阴虚齿衄 郁火上冲睑弦赤烂 心火炽盛小便黄赤 肾阴虚胫瘘 肝郁化火经断复行 气滞血瘀皮肤肥厚
口唇红肿	胃火口唇红肿 痰火口唇红肿 脾阴虚口唇红肿
消瘦	肾精亏虚下肢生疽:多发于儿童及靑年 诸虫积滞异嗜 脾肾两虚短气 阴虚火旺吐血 脾胃虚寒流瘅 阴虚津亏噎膈 肺气虚尿频 阴血亏虚多汗 胃热炽盛消瘦 肝肾阴虚朱砂掌 肝肾阴虚单腹胀大 气血两虚大便变形 脾胃虚寒胃痛 睥虚湿困疳翳 心脾气虚小儿多动 营虚半身麻木 脾肾拓虚毛发脱落 下焦虚寒大便脓血 疳积喜食异物 血虚阴亏便秘 气血虚弱消瘦 虚热便血 脾胃气虚消瘦 肺阴虚消瘦 阴虚风内动手颤 肝肾阴虚慢惊 气血亏虚缺盆溃烂 瘀血内阻噎膈 胃热阴伤消渴 心血不足盗汗 阴虚火旺血精 心虚禀弱啼哭 痰火郁结结节 班血阻络面具脸 血虚阴亏手足心热 脾肾两虚尿浊 肝肾阴虚月经过多 气血两虚胎位不正 脾虚失调囟门不合 阴虚津亏舌裂 湿热五色带 嵌血内阻舌紫 胃火炽盛善食易饥 肝火充盛消瘦 肝肾阴虚面诟 虚寒五色带 虫积白斑 肾阴欲竭舌光 肝肾虚损膝肿痛 营血虚热須发早白 气血两虚毛发变异 血虚生风肛门瘙痒 肝肾阴虚便血 痰气互结噎膈 气血两虚流产后闭经 虫积消瘦 肝经虚寒流泪 伤食积滞疳翳 阴虚血亏潮热 气血损伤烧虫扰动症 阴虚火旺经行发热 脾胃虚寒异嗜
口甜	脾胃湿热口甜 脾胃气阴两虚口甜 湿邪犯肺咳痰 脾胃积热口甜
肠鸣	肝脾不和肠鸣 虚寒腹泻 湿热腹泻 中焦寒湿肠鸣 痰饮中阻舌答灰黑 寒凝腹痛 寒凝积冷挤腹痛 肾虚腹泻 肠胃湿热肠鸣 脾肾阳虚肠鸣 宿食积滞舌腐 水饮内停大便溏 痰湿中阻扬鸣 风寒腹泻 睥肾气虚骨痛 中气不足肠鸣
尿道溢胺	肝气郁结尿道溢脓 湿热疫毒尿道溢胺 睥肾两虚尿道溢脓 阴虚内热尿道溢脓
头摇	风阳上扰头摇 阴虚动风头摇
产后发痉	风寒产后发痉 血虚产后发痉 邪毒炽盛产后发疫
脱肛	气虚里急后重 中气下陷大便溏 脾虚气陷遗尿 肾阳虚脱肛 脾气下陷脱肛 湿热蘊结脱肛 气血损伤烧虫扰动症 中气不足肠鸣 脾气下陷上胞下垂 肺气虚便难
五心烦热	阴虚火旺暴盲 阴虚火旺皮肤褐斑 肾阴虚证口咸 相火偏旺性早熟 阴虚火旺吐血 火郁五心烦热 肝肾阴虚四肢瘦削 脾经伏热舔舌 阴虚内热舌红绛 肾阴虚尿频 阴虚火旺红斑 肝肾阴虚视物变形 阴虚火旺心中懊侬 水火不济善喜 气阴两虚舌剥 肾虚腰脊痛 血虚月经过少 阴虚火旺经行口糜 虚火灼齿牙痛 肾阴虚喷嚏 阴虚火旺妊娠心烦 相火偏旺滑胎 虚火上炎重舌 肝肾阴虚小便失禁 阴虚风动小儿抽动 阴虚火旺妄听妄视 肝肾阴虚经断前后诸症 肾火偏亢脐内出血 心肾不交梦游 肾阴虚皮肤黑斑 阴虚火旺舌痛 虚热便血 肺阴虚消瘦 心肝阴虚颈粗 阴虚内热面色红 阴虚火旺心下悸 肾阴亏虚尿频 肾阴亏损云翳 肾经虚火胬肉 肝肾阴虚白睛红赤 阴虚内热小便黄赤 阴虚内热尿道溢脓 肺肾阴虚咽肿 阴虚肝旺晕厥 阴虚阳亢生风四肢抽搐 阴虚火旺咽喉白腐 阴虚五心烦热 阴虚津亏产后小便淋痛 阴虚火旺视瞻昏渺 肾虚风湿阴茎溃烂 心血不足盗汗 气阴两虚天疱疮 肝肾阴虚 肝肾阴虚瞳神缩小 肝肾阴虚善怒 肝肾阴虚阴痛 肾阴虚火旺牙龈肿痛 邪伏阴分五心烦热 肺肾阴虚鼻塞 肝肾阴虚月经过多 阴虚产后多汗 肾阴虚耳聋 阴虚动风啮齿 肝肾阴虚交接出血 肝热阴虚腋汗 阴血亏虚目干涩 肾阴虚损鼻衄 肝肾阴虚面诟 血虚五心烦热 肾阴虚崩漏 肾阴欲竭舌光 胃热阴虚齿衄 肾虚肝旺小儿多动 肝肾阴虚便血 肾阴不足头热 肾阴虚胫瘘 肝肾阴虚头昏 痰气交阻乳房肿块
胎水肿满	脾肾阳虚胎水肿满 脾气亏虚胎水肿满
小儿脐突	胎热小儿脐突 眙禀亏虚小儿脐突
目珠自胀	外感风热目珠自胀 气血亏虚目珠自胀 肝郁气滞目珠自胀
心胸汗出	心脾气虚心胸汗出 心肾阴虚心胸汗出
恶露不断	血热恶露不断 阴虚悉露不断 气虚恶露不断 血瘀恶露不断
头汗	湿热熏蒸头汗 阳气不足头汗 湿热蕴蒸头重 热实结胸心中懊侬
手指挛急	血燥筋伤手指挛急 血不养筋手指挛急 寒滞经脉濡手指挛急
皮肤疣赘	风热蕴肤疣赘 风热疫毒疣赘 血虚风燥疣赘 气血嵌滞疣赘
关节疼痛	风胜行痹关节疼痛 脾肾阳虚肌肤疼痛 气血瘀滞结节 风寒阻络猫眼疮 痰瘀辨阻关节变形 寒湿阻络骨痛 毒热炽盛蝶形红斑 气血两虚关节疼痛 湿热下注紫斑 血疲经行身痛 湿胜着痹关节疼痛 寒湿凝滞四肢肿胀 寒胜痛痹关节疼痛 睥肾气虚骨痛 气血亏虚四肤疼痛 湿热阻瘠关节疼痛 热邪阻络四肢疼痛 寒滞肝脉阴痛 风湿客表恶寒发热 湿热阻痹骨痛 风湿热痹阻蝶形红斑 瘀血阻络关节疼痛 肝肾亏虚关节疼痛 风寒湿阻臂痛 寒湿阻络白庀 风湿热郁发癍 风湿痹阻足痛 风寒湿阻足跟痛 痰湿阻滞麻木
背热	肺火背热 阴虚背热 署湿籩结肩背痈肿
壮热	疫毒侵袭肺胃丹痧 毒热炽盛肌肤疼痛 火毒凝滞腋窝红肿 热盛伤津舌干 热毒攻心神昏 暑湿流注鼠蹊肿痛 暑热惊风 热炽营血壮热 热毒攻心谵语 热深厥深身热肢寒 邪毒内陷心肝 肺胃火热颈间生疮 气分热盛烦躁 热毒壅肺鼻肿 湿热蕴结壮热 肺胃明伤余热丹痧 热入营血暴盲 肺热炽盛壮热 热陷心包舌卷 热毒炽盛脓疱 肠道热结壮热 热结肠道但热不寒 阳明捬实烦躁 热炽阳明但热不寒 热极或湿热生风四肢抽搐 肺胃热盛乳娥 肺胃蕴热小儿音哑 阴虚火毒颈后生痈 热入心包舌强 阳明经壮热 感受疫毒大便脓血 胎毒发热 毒热炽盛丹毒 热盛动风啮齿 邪毒炽盛闭肺内陷《陷逆证》 风热相搏眼睑丹毒 疟疾寒战 邪入营分发热 疼毒外达肺部苔热《见形期〉 毒热内盛脐疮 外邪客宵呕吐 里热壅盛口噤 疫毒供灼气营丹痧 外感暑邪发热 毒热炽盛水痘 大肠湿热壮热
但热不寒	热入营血但热不寒 邪热壅肺但热不寒 热结肠道但热不寒 热炽阳明但热不寒 湿热郁蒸但热不寒 暑热伤气但热不寒
肛门疼痛	虚寒胚门疼痛 实热肛门疼痛 血挤肛门疼痛 湿热肛门疼痛 虚热肛门疼痛 气滞胚门疼痛
舌苔灰黑	脾阳虚衰舌苔灰黑 热灼肾阴舌苔灰黑 痰饮中阻舌答灰黑 湿热内蕴舌苔灰黑
大便变形	气血两虚大便变形 湿热蕴结大便变形
小儿蛔虫症	蟈虫扰动穿肠入胆症 胃肠湿热蛔虫扰动症 脾胃不调鑕虫扰动症 蝈虫扰动梗阻肠道症
手舞足蹈	气血亏虚手舞足蹈 肾精亏虚手舞足蹈 肝郁血虚手舞足蹈 肝肾阴虚手舞足蹈 妇女妊娠手舞足蹈 外感风邪手舞足蹈
面色蒌黄	脾气虚少气 气血虚衰肛门流脓 脾胃气虚眼皮跳 脾阳虚衰舌苔灰黑 脾虚血弱紫癜 脾胃虚弱月经过少 心脾气血两虚头晕 气血两虚不孕 脾胃阳虚慢惊 血虚胎动不安 脾气虚食后困顿 中气虚损腹中痞块 脾虚气弱小儿青盲 脾气亏耗头倾 脾肾两虚尿浊 气血虚弱闭经 脾虚失调囟门不合 肝肾阴虚单腹胀大 脾虚湿盛湿疮 醇气虚面色蒌黄 气血两虚动风四肢麻木 阳虚水泛身重 湿热下注胫痠 脾阳不振小便不利 脾不统血发癍 气虚痰结发癫 脾虚湿蕴鼾眠 疳积喜食异物 脾胃虚弱耳聋 痰食凝结腹中痞块 心脾不足吐血 心脾两虚善疑 脾经湿热目生椒粟 气血两虚流产后闭经 气血两虚产后浮肿 气血两虚毛发脱落 气血不足脐疮 脾虚腹泻 时发时止大便脓血 气血亏虚目珠自胀 脾虚湿困面色蒌黄 阳虚自汗
乳汁不行	血嵌乳汁不行 肝郁气滞乳汁不行 气血两虚乳汁不行
肛漏	虚寒肛漏 虚热肛漏 实热肛漏
舌剥	气阴两虚舌剥 胃阴虚舌剥
短气	痰饮中阻短气 脾宵气虚口疮 气阴两虚反胃 肺脾气虚鼻干 肾气不足精液清冷 肝肾虚腰膝无力 脾肾两虚短气 肾虚痰阻气喘 气阴两虚胸痛 气血两虚便血 肺寒咳痰 精血亏虚脱形 心气亏虚胸痛 心血瘀阻胸闷 气虚自汗 气阴两虚舌剥 痰浊阻滞胸痛 气滞血瘀短气 风湿外袭恶风 痰饮中阻舌答灰黑 脾不摄血紫斑 心脾两虚短气 痰湿肩痛 痰食凝结腹中痞块 心血褒阻心悸 肺虚感寒鼻痠 心肝阴虚颈粗 胸供肩不举 脾胃气虚口淡 胃阴虚恶心
口唇湿烂	睥胃湿热口唇湿烂 脾胃菹湿口唇湿烂 气滞血挤口唇湿烂 血虚风燥口唇湿烂
缺盆溃烂	湿热蕴结缺盆溃烂 气血亏虚缺盆溃烂
皮肤水疱	脾虚湿泛水疱 湿热蘊结水疱 虫毒菹肤水疱 风湿蕴肤水疱 寒湿凝滞水疱
蝶形红斑	阴虚内热蝶形红斑 脾肾不足煤形红斑 气滞血疲蝶形红斑 风湿热痹阻蝶形红斑 毒热炽盛蝶形红斑
肩不举	胸供肩不举 肩凝肩不举 痹痛肩不举 损伤肩不举
经行呕吐	脾胃虚弱经行呕吐 肝气犯胃经行呕吐 痰饮伏胃经行呕吐
产后眩晕	血瘀产后眩晕 血虚产后眩晕
小儿木舌	心脾壅热木舌 阴虚津亏木舌
鼻痒	风热犯肺鼻痒 肺肾阴虚鼻塞 肺气虚寒喷嚏 热毒侵肺鼻痒 脾经湿热鼻痒 肺经燥热鼻痒 风热犯肺喷嚏 肾阴虚喷嚏 肺气虚鼻痒
咳血	外感咳血 瘀阻肺络咳血 脾肺气虚咳血 肺热壅盛咳血 阴虚肺燥咳痰 阴虚火旺咳血
阴疮	外伤邪毒阴疮 肝肾阴虚阴疮 脾胃积热阴疮 肝胆湿热阴疮
肛门流脓	气血虚衰肛门流脓 湿热遂阻肛门流脓
痫	风痰闭神痫 痰瘀互结痫 肝肾阴虚小便失禁 贤虚供亏痫 脾虚肝旺妊娠疫厥 疲蒙清窍痴呆 风邪袭表恶风 痰火扰神痫 血虚神闭痫
红丝赤缕	瘀血阻络红丝赤缕 阴虚内热红丝赤缕
云雾移睛	肝肾亏损云雾移睛 气血两虚云雾移睛 湿热蕴蒸云雾移睛 痰浊上蒙云雾移睛
目札	肝气乘脾目札 伤食积滞疳翳 肝经风热目札 脾伤疳积目札 肝虚血少目札
口腻	湿热中阻口腻 寒湿困脾畏寒 寒湿困脾口腻 痰湿阴吹 痰热藴脾口腻 脾虚湿阻盗汗
项强	风寒五硬 热实结胸心中懊侬 邪热伤津项强 班血阻络面具脸 热盛动风神昏 热动肝风面色青 肝经风热小儿青盲 风寒束表项强 肝胃积热颈间生疮 暑热惊风 太阳伤寒头冷 邪毒内陷心肝 肺胃火热颈间生疮 外伤风毒口噤 风湿犯表项强 风寒束表舌苔白 金疮风毒项强 热极或湿热生风四肢抽搐 风湿犯表颈项痛 太阳伤寒腰脊痛 痰热动风四肢强直 风邪入侵四肤强直 里热壅盛口噤 邪毒炽盛产后发疫 外感暑邪发热 一、湿热初侵，邪犯肺胃
舌干	水饮内停口渴 阴虚内热大便脓血 气明欲脱绝汗 脾胃气阴两虚口甜 阴虚津亏舌干 风火燥结肛门生痔 热盛伤津舌干 津气亏虚白痏 酒毒内茧舌紫 气阴两虚胸痛 阳明腑实舌生芒刺 肺燥喉痒 血虚生风肛门瘙痒 胃肠实热便秘 血虚肠煉肛裂 胃阴不足呃逆 大肠热结便难 阳虚津不上承舌干 肺热熏灼舌萎 署湿籩结肩背痈肿 胃火燔龈牙痛 胃阴不足呕吐 脾虚湿因疲乏
肛门肿胀	气滞血瘀肛门肿胀 湿热里结肛门肿胀
腹露青筋	气滞湿阻腹露青筋 肝肾阴虚腹露青筋 肝脾血疲腹露靑筋 脾肾阳虚腹露青筋
月经过多	脾气虚弱月经过多 湿热下注月经过多 瘀血阻滞月经过多 肝肾阴虚月经过多 脾不统血发癍 冲任虚寒月经过多 肝火偏亢月经过多 阴虚火旺汗血
囟门不合	肾虚费弱囟门不合 脾虚失调囟门不合
经行吐衄	阴虚肺燥经行吐衄 肝郁化火经行吐衄 脾不统血经行吐衄 胃火血热经行吐衄
口酸	睥虚肝乘口酸 食积胃肠口酸 肝火犯胃吐血 肝郁化火口酸
黄汗	营卫壅闭黄汗 湿热蕴积黄汗
恶露不下	血疲恶露不下 气滞恶露不下 气血两虚恶露不下 寒凝恶露不下
恶心	肝胆湿热胁痛 风热化火丹毒 风热痰盛口颊澳烂 饮食不进大便脓血 湿热发黄 脾胃虚弱积滞 伤食呕吐 胃肠湿热大便胺血 脾肾阳虚经行泄泻 热毒籩结腹部硬满 寒湿中阻腹满 毒热炽盛脱屑 风热上扰颜面红肿 湿困脾胃口淡 痰湿上逆头目胀痛 痰浊阻肺气喘 阴虚肝旺妊娠痉厥 胃热痰浊上逆舌腐 肝胃不和嘈杂 胃热恶心 食滞胃肠嗳气 疲热扰心不寐 风热牙疳 肝胆湿热尿血 风痰经行抽搐 痰湿咳嗽 胃阴虚恶心 胃阴不足呕吐 一、湿热初侵，邪犯肺胃 湿热壅滞舌苔黄 食积胃痛 饮热互结腹部硬满 痰湿阻络目偏视 外邪干胃呕吐 肝胃不和恶心 伤食恶心 蝈虫扰动梗阻肠道症 胃热妊娠呕吐 胃寒恶心 痰湿白带 误食中毒舌不知味 痰饮壅盛憋气 脾虚痰湿妊娠眩晕 气随血脱异位妊娠 食滞脾胃低热 脾虚肝旺妊娠疫厥 湿热郁蒸心中懊侬 胃肠湿热蕴毒便血 脾虚湿蕴鼾眠 湿热蕴蒸头重 风痰郁结痰核流注 风痰闭神痫 痰滞妊娠呕吐 脾胃湿热脐漏 痰气痞 风痰入络手颤 痰湿阻滞闭经 升降失常腹部硬满 肝胆湿热小便黄赤 毒入血分皮肤红线 痰湿内阻头晕 寒湿阻滞腹筋挛急 痰浊阻滞梦游 伤食嘈杂 肝胃不和呕吐 伤食产后发热 热毒壅盛妇人腹痛 阴虚阳浮消渴 脾胃不调鑕虫扰动症 血虚产后眩晕 气血损伤烧虫扰动症
鼻臭	脾虚湿热鼻臭 胎毒内遼体臭 肝胆湿热鼻臭
夜间多尿	脾肾阳虚便秘 脾肾两虚夜间多尿 肾阳虚惫夜间多尿
产后多汗	气虚产后多汗 阴虚产后多汗
大便艰难	痰气互结噎膈 湿热雄结便难 脾肾阳虚便难 大肠热结便难 肺气虚便难 肝脾气滞便难 阴虚血亏便难
头胀	肝胆火炽曈神缩小 湿著肌表身重 风热外袭头胀 风湿客表恶寒发热 阴虚肝旺妊娠痉厥 肾火偏亢脐内出血 肝郁阴虚经前乳胀 外感寒湿舌苔白腻 心肝火旺经前不寐 火郁五心烦热 湿阻气滞头胀 肺经郁热鼻塞 肝火上炎头胀 湿著肌表身痛 暑湿咳嗽 气郁五色带 肝热产后乳汁自漏 寒湿束表无汗 暑湿袭表恶寒发热 肝肾虚热阴茎溃烂 肝火犯肺鼻衄
阴痒	肝经湿热阴冷 肝肾阴虚阴痒 湿热下注阴痒
恶寒	风寒束表咳嗽 外感风热白睛红赤 湿热熏蒸头汗 外感风寒发热 毒热炽盛肌肤疼痛 邪热费肺胸闷 暑湿流注鼠蹊肿痛 肺寒咳痰 寒饮内停恶寒 外感风寒舌肿 邪伏募原恶寒 暑湿袭表恶寒发热 亡阳液脱四坡拘急 风邪犯表产后发热 湿热下注臁疮 寒凝阳虚舌青 风邪闭阻四肢抽搐 少阴寒化恶寒 风寒束表舌苔白 外感风寒经行发热 风邪袭络顔面抽描 热入血室经来骤止 风寒束表啮齿 寒疲阻肺哮鸣 寒湿侵袭背痛 肺燥喉痒 风热牙龈肿痛 肝郁血热腋窝红肿 风寒袭络牙齿痠弱 火毒凝结肩背痈肿 表寒里热无汗 寒礙肝脉畏寒 外感风热漏睛 外感疟部寒热往来 外邪客宵呕吐 战汗寒战 风寒欲解鼻衄 邪毒炽盛产后发疫 湿热郁蒸但热不寒 湿热化火丹毒 外邪干胃呕吐 湿热蕴蒸颈后生痈 肾阳虚咳嗽 风寒束表项强 邪热壅肺但热不寒 胃热炽盛舌苔黄 凉燥袭肺恶寒 邪郁少阳恶寒 寒湿阻络角弓反张 风热犯肺恶寒发热 风湿犯表项强 火毒盖结臀部痈肿 血褒乳房红肿 实热费积胚周痈肿 热入营血但热不寒 风寒妊娠头痛 风中经络半身不遂 风邪犯表足热 湿热蘊结肛裂 拖接初期恶寒 风寒湿凝滞下肢生疽 风湿客表恶寒发热 湿阻膝原舌苔白腻 阳明经证面色红 阳明蓄血善食易饥 阳明经壮热 肺脾积热胞睑肿胀 毒热织盛发疱 毒热蕴滞丹毒 肾阳虚弱遗尿 风热外袭面色红 外感风温发热 寒湿阻滞腹筋挛急 膀胱湿热尿频 风寒产后发痉 风寒袭表恶寒发热 外感风寒经行身痛 热毒壅盛妇人腹痛 暑热伤气但热不寒 风寒袭肺白睛溢血 痰饮内伏背冷 脾虚湿因疲乏 风寒妊娠音哑 外感咳血 风寒表实无汗 寒热痞 寒滞肠道面色白 外感寒湿舌苔白腻 阳明热织角弓反张 外寒内热寒战 风寒束表恶寒 湿著肌表身痛 时行疫毒咽喉白腐 胃肠湿热大便胺血 太阳伤寒头冷 寒湿袭表舌苔白 热毒壅盛鼠蹊肿痛 风寒表证口噤 寒邪外束寒战 风热唇肿 血虚口唇淡白 湿著肌表身重 风寒声音嘶哑 热结肠道但热不寒 风寒鼻塞 风寒束表面色白 风湿犯表颈项痛 太阳伤寒腰脊痛 火毒炽盛皮肤红线 风邪犯肺咳痰 风寒妊振腹痛 外感风热经行发热 脾肾阳虚紫斑 风热相搏眼睑丹毒 风寒目痒 脏嘛火毒指头疔肿 风寒腹泻 太阳伤寒欲解战汗 寒邪束表面色青 真热假寒恶寒 外感风热针眼 審热逋结白庀 表寒里热气喘 阳虚筋惕肉哺 风寒束肺胸闷 余毒上攻口颊攒烂 风寒束表背冷 疫留气分欲解战汗 风寒产后身痛 风寒鼻流涕 火毒凝滞腋窝红肿 热毒炽盛痄腮 乳积乳房红肿 风寒闭肺气喘 肺气不足胎弱 虚寒吐泻 心阳虚阴盛心烦 寒热错杂哮鸣 风寒妊娠咳嗽 风寒袭肺耳胀闷 疮毒内陷寒战 风寒束表身痛 金疮风毒项强 热炽阳明但热不寒 麻毒时邪由里出表〔初热期〉 表寒郁热烦躁 风热挟疾颈项痛 走马牙疳 风寒外侵无名肿毒 湿热壅滞带状疱疹 风寒喉痒 风寒袭肺喷嚏 疟疾寒战 湿热毒费猫眼疮 风邪入侵四肤强直 金创风毒角弓反张
妊娠咳嗽	燥热妊娠咳嗽 风热妊娠咳嗽 脾虚痰湿妊娠咳嗽 风寒妊娠咳嗽 肺肾气虚妊娠咳嗽 阴虚妊娠咳嗽
鼻痛	风寒湿邪壅滞鼻痛 风热壅肺鼻痛 肺胃热盛鼻痛
掌跖发疱	脾虚湿盛发疱 湿热蕴结发疱 毒热织盛发疱 湿毒浸淫发疱
鼻痠	肺虚感寒鼻痠 风热壅肺鼻痠 痰火阻肺鼻痠 肺脾气虚鼻疫
初生儿大便不通	胎襄不足大便不通 胎热壅结大便不通
小儿蛲虫症	脾胃虚弱蛲虫扰动症 气血损伤烧虫扰动症
漏睛	热邪稍留漏睛 外感风热漏睛 心火炽盛漏睛 气血两虚漏睛
胞内生肉	风热壅盛胞内生肉 阴虚火炎胞内生肉
四肢肿胀	气滞肌表四肢肿胀 寒湿凝滞四肢肿胀 气虚血瘀四肢肿胀 脾肾阳虚经行浮肿 湿热蕴结四肢肿胀
妊娠尿血	心火亢盛妊娠尿血 肝经郁热妊娠尿血 阴虚火旺妊娠尿血
少气	肺气虚少气 胃寒嘈杂 气血两虚星翳 脾胃虚弱四肢瘦剖 气血亏虚汗出偏沮 气血两虚舌光 气血两虚关节疼痛 肾不纳气少气 脾气虚口唇淡白 脾胄虚寒多唾 睥肾气虚骨痛 醇气虚面色蒌黄 气血亏虚四肤疼痛 睥肾两虚喉中痰鸣 气虚里急后重 气血两虚老花眼 气血两虚脱形 气阴两虚舌光 阳虚面色白 气虚下陷大便失禁 气血虚弱消瘦 气血两虚疲乏 脾胃气虚消瘦 脾不统血经行便血 脾胃气虚瘫痪 暑耗肺胄气阴疲乏 心脾两虚多梦 心气虚少气 气血两虚脱发 肺脾气虚倒睫 气虚齿动牙痛 气血两虚啮齿 气虚血瘀面痛 中气不足肠鸣 气虚肥胖 脾气虚脱形 脾气虚弱夜盲 脾气虚少气 气血亏虚手舞足蹈 脾气虚头晕 心气虚心悸 气虛低热 寒邪凝滞胚周痈肿 气虚舌纵 肾虚腰痛 气虚血褒股阴痛 肺阴虚咳嗽 脾虚气弱小儿青盲 胃寒恶心 脾胃气虚潮热 热伤气阴少气 气血两虚胎位不正 脾虚气陷遗尿 心阳虚心悸 睥肾阳虚脑髓失充囟陷 气阴两伤心中懊侬 脾虚舌胖 气血两虚毛发变异 脾胃虚寒反胃 热扰胸鎘心中懊侬 虚寒肛漏 气血两虚动风口眼呙斜 肺气虚便难
郑声	亡阴郑声 亡阳郑声
口唇淡白	血虚口唇淡白 心气虚心悸 脾气虚口唇淡白
皮肤肥厚	风湿蕴肤皮肤肥厚 血虚风燥皮肤肥厚 脾虚血燥皮肤肥厚 气滞血瘀皮肤肥厚
崩中	血热崩中 脾气进崩中 肝肾阴亏崩中 气血两虚麻木 肾阳虚崩中 脾不摄血紫斑 血班崩中 脾不统血红斑
小儿口疮	心脾积热口疮 虚火上浮口疮
口眼呙斜	风邪外袭口眼呙斜 风疲入络口眼呙斜 肝气郁结口眼呙斜 气血两虚动风口眼呙斜 肝风内动口眼呙斜
嘈杂	胃寒嘈杂 胃火炽盛舌疮 胃阴虚胃痈 脾胃虚弱经行呕吐 脾胃热盛咽干 肝胃不和嘈杂 胃热炽盛鼻干 胃热恶心 余热扰服不寐 虫积消瘦 肺胃津亏瘫痪 蝈虫啮齿 胃实热吐血 伤食嘈杂 胃热嘈杂
小儿乳娥	肺胃热盛乳娥 风热外袭乳娥 虚火上炎乳蛾
头热	肾阴不足头热 肝火上炎头热 虚阳浮越头热
小便不通	气滞产后小便难 膀胱湿热小便黄赤 气虚产后小便难 脾气虚妊娠小便不通 元气虚弱小便不通 肾气不足小便不通 中气不足小便不通 血瘀产后小便难 肝气郁结小便不通 肾气虚产后小便难 肺气壅滞小便不通 热结膀胱小便不通 溺道瘀阻小便不通 下焦湿热小便不通 气滞妊娠小便不通
阴痛	肝郁气滞阴痛 肝经湿热阴痛 寒滞肝脉阴痛 肝肾阴虚阴痛 气虚下陷阴痛
目视无神	阴血亏虚目视无神 精气衰败目视无神
舌纵	心火炽盛舌纵 肝气郁结舌纵 气虚舌纵
吐血	热入营血发癍 脾肾阳虚吐血 瘀阻肺络咳血 邪入血分发热 肝火犯胃吐血 痰火扰心心悸 褒血攻心谵语 热入营血面色红 血分热毒舌紫 阴虚火旺吐血 心脾不足吐血 胃膀血挤吐血 疲血阻滩反宵 热炽营血壮热 胃实热吐血 肝火上炎面色红 肝火犯胃宵痛 热入营血烦躁 瘀阻胃络胃痛
少腹痛	寒滞肝脉少旗痛 肝气郁结少腹痛 肠道湿热少腹痛 肝寒少腹痛 血疲产后身痛
小儿尿白	湿热下注尿白 乳食积滞尿白
舌淡白	血虚生风眼皮跳 气血亏虚手舞足蹈 肾精亏虚手舞足蹈 气虚血瘀四肢肿胀 脾胃虚弱月经过少 气虚血褒股阴痛 气血两虚舌光 肾阳虚摊痕 肺寒咳痰 妇女妊娠手舞足蹈 气血两虚舌淡白 亡阳液脱四坡拘急 气血两虚胎位不正 阳脱面色白 血瘀气滞四肢强直 脾经虚寒啼哭 肝郁血虚手舞足蹈 血虚风袭手颤 脾不摄血紫斑 水寒气从少腹上冲 脾虚寒湿舌淡白 肝肾亏虚半身不遂 胎寒五硬 气虚血挤半身不遂 气虚血瘀面痛 风寒湿阻四肢强直
皮肤白庀	湿热白庀 血热白庀 寒湿阻络白庀 血虚白庀 審热逋结白庀 血疲白庀
舌不知味	痰迷心窍舌不知味 误食中毒舌不知味 心血虚舌不知味
舌麻	血虚舌麻 风热上扰颜面红肿 肝风舌麻 痰阻舌麻
步态不稳	气郁疾阻步态不稳 脾肾亏虚步态不稳 肝肾阴虚步态不稳
肩痛	瘀血肩痛 胸供肩不举 风寒肩痛 痰湿肩痛 痹痛肩不举
足趾发黑	寒湿下注足趾发黑 湿毒下注足趾发黑 瘀血阻滞足趾发黑 肝肾阴虚足趾发黑
四肢麻木	风痰阻络四胺麻木 肝阳化风四肢麻木 风中经络四肢麻木 肝肾亏虚痴呆 湿热部阻四肢麻木 气滞血瘀四肢麻木 痰阻舌麻 气血两虚动风四肢麻木
胫痠	湿热下注胫痠 肾阴虚胫瘘 肾气虚胫痠
阴部水疱	肝肾阴虚阴部水疱 血热染毒阴部水痕 湿热下注阴部水疱 气虚湿毒阴部水疱
头白秃	湿热挟毒头白秃 风热挟毒头白秃
腰冷	表虚风湿腰重 风寒腰冷 寒湿腰重 寒湿腰冷 肾阳虚衰腰冷
谵语	风热化火丹毒 热织阳明谵语 营分热盛舌生芒刺 湿热蒙蔽谵语 阳明腑实谵语 热入营血口渴 褒血攻心谵语 痰火上扰谵语 真热假寒面色白 温热时毒颜面红肿 热毒攻心谵语 热炽营血壮热 热毒籩结腹部硬满 热毒内陷营血鼻肿 疮毒内陷寒战 热入营血但热不寒 阳明腑实潮热 心火亢盛舌衄 热结肠道但热不寒 阳明捬实烦躁 痢毒上攻谵语 热入心包舌强 心火炽盛小便黄赤 血热扰神心烦 阳盛实热舌红绛 阳明实热舌裂 热入血室妄听妄视 胃肠实热政满 热入营血红疹 邪入营分发热 热入营分谵语 疫毒供灼气营丹痧
毛发变异	精血亏虚毛发变异 血热化燥毛发变异 气血两虚毛发变异
腰重	表虚风湿腰重 寒湿腰重 肾阳虚腰重
小儿风疹附奶麻	卫分邪热风疹 气分邪热风疼
麻疹	邪透疼没肺胃阴伤〈收没期〉 邪毒炽盛闭肺内陷《陷逆证》 麻毒时邪由里出表〔初热期〉 疼毒外达肺部苔热《见形期〉
妊娠发疹	风热妊娠发疹 血虚妊娠发疹
呕吐	肝胆湿热胁痛 风热化火丹毒 胃阴虚呕吐 虫扰胆府手足厥冷 风热痰盛口颊澳烂 肝气犯胃经行呕吐 寒邪犯胃胃痛 饮食不进大便脓血 湿热发黄 心脾积热啮齿 气逆气从少腹上冲 寒饮内停恶寒 暑热惊风 脾胃虚弱积滞 伤食呕吐 寒滞肝脉少旗痛 胃肠湿热大便胺血 脾肾阳虚经行泄泻 邪毒内陷心肝 亡阳液脱四坡拘急 热毒籩结腹部硬满 痰饮伏胃经行呕吐 少阴寒化恶寒 乳食不节积滞 寒湿中阻腹满 痰浊内阻手足厥冷 风热唇肿 伤食积滞啼哭 风热上扰颜面红肿 食滞吐泻 脾胃虚弱经行呕吐 水饮凌心小儿心悸 痰湿上逆头目胀痛 时疫霍乱吐泻 食积腹痛 痢毒上攻谵语 胃热吐蚘 肝火犯胃头目胀痛 胃寒妊娠呕吐 阳气郁阻手足厥冷 水气凌心心下悸 风热牙疳 寒礙肝脉畏寒 阳虚身振摇 外邪客宵呕吐 痰湿咳嗽 肝热妊娠呕吐 痰火郁结瞳神散大 胃阴虚恶心 一、湿热初侵，邪犯肺胃 湿热壅滞舌苔黄 食积胃痛 痰浊上蒙晕厥 饮热互结腹部硬满 脾胃虚寒黄液上冲 胃有秽浊不乳 痰湿阻络目偏视 肝阳化风半身不遂 痰火扰神心下悸 食滞惊风 外邪干胃呕吐 热毒炽盛痄腮 蝈虫扰动梗阻肠道症 胃热妊娠呕吐 惊恐呕吐 误食中毒舌不知味 肝寒少腹痛 痰饮壅盛憋气 伤食腹泻 肝火犯胃宵痛 胃热呕吐 气随血脱异位妊娠 胃寒呕吐 痰火内扰妊娠心烦 肝郁气滞胃痛 中焦寒湿肠鸣 痰饮中阻舌答灰黑 胃肠湿热蕴毒便血 乳食积滞尿白 胎毒菹结丹毒 食滞宵肠啮齿 过食生冷积滞 痰滞妊娠呕吐 痰气痞 升降失常腹部硬满 肝胆湿热小便黄赤 蟈虫扰动穿肠入胆症 毒入血分皮肤红线 痰湿内阻头晕 肝胃不和呕吐 痰浊阻滞梦游 伤食产后发热 血虚产后眩晕 气血损伤烧虫扰动症 寒湿吐泻 疟各痞块
小儿鹅口	脾肾阴虚箱口 心脾积热银口
口淡	脾阳虚产后浮肿 水湿困脾浮肿 风寒束表背冷 寒滞扬道面色青 脾胃虚弱月经过少 寒滞肠道面色白 脾不统血鼻紐 痰湿白带 寒湿困脾口腻 虚寒吐泻 阴寒内盛小便清长 气阴两虚口淡 睥肾气虚骨痛 胃寒吐蚘 湿困脾胃口淡 血虚口唇淡白 腑肾阳虚食欲不振 脾阳虚畏寒 脾肾阳虚四肢抽搐 阳虚面色白 阳虚舌边齿痕 阳虚寒盛寒战 风寒妊振腹痛 脾胃湿热口甜 寒湿困脾畏寒 睥虚湿泛妊振肿胀 脾气虚弱经行泄泻 脾气虚弱经断复行 脾胃气虚口淡 胃寒干呕 寒湿吐泻
啮舌	热盛动风啮舌 风痰上扰啮舌
烦躁	肝胆火旺善怒 气郁低热 诸虫积滞异嗜 毒热炽盛肌肤疼痛 阳明腑实谵语 肝郁气滞皮肤黑斑 肝火上炎白睛溢血 毒热炽盛蝶形红斑 热盛伤津舌干 血虚肝郁小儿青盲 心脾积热重舌 痰浊壅闭咽喉白腐 心肾不交多梦 毒热炽盛脱屑 阴虚阳亢善疑 气郁阴吹 疳积脾虚手足心热 湿热蘊肺咳痰 肝郁气滞经行情志异常 肝火犯胃头目胀痛 肝经郁热不寐 肝郁化火妊娠消渴 肝肾亏虚关节变形 心火炽盛舌纵 表寒里热无汗 阳明实热舌裂 气血亏虚缺盆溃烂 肝火上炎面色红 肝火犯肺咳嗽 热入营血红疹 热入营分谵语 外感惊风 外邪客宵呕吐 气滞血瘀经间期出血 疫毒供灼气营丹痧 热入营血烦躁 一、湿热初侵，邪犯肺胃 肝阳上扰头晕 肝阳上扰头痛 胃肠实热舌苔黄 阴虚血热胎萎不长 阴虚火旺妄想 情志异常异嗜 肝郁气滞阴痛 痰热惊风 热炽气分口渴 热毒攻心谵语 肝郁气滞经行腹痛 肝胆郁热瞳神干缺 暑伤肺胃夏季热 气分热盛烦躁 肝胆火热赤膜下垂 肝胆湿热妊娠疫痒 肝火犯胃宵痛 肝阳上亢妊娠头痛 热入营血但热不寒 疫毒凌心咽喉白腐 阴虚火旺发狂 气滞血褒过期不产 肝风舌颤 肾虚肝旺小儿多动 肝火上逆暴盲 阳盛实热舌红绛 心脾壅热木舌 情志异常喜食异物 暑热伤气但热不寒 心阴虚心悸 肝风内动身振摇 心经积热啼哭 湿热腹泻 暑热伤气潮热 肾虚费弱囟门不合 肝胆湿热尿频 气虚肝热轮上赤豆 心火炽盛善喜 热入营血口渴 风热湿毒耳痒 血分热毒舌紫 肝郁气滞性早熟 实热腹痛 心火充盛善惊 胃火燔齿牙齿焦黑 胃火炽盛妊娠消渴 热深厥深身热肢寒 热结膀胱小便不通 脐结松脱脐出血 热毒内陷营血鼻肿 肝郁化火经前乳胀 阴虚火旺烦躁 气滞血疲胞衣先玻 热结肠道但热不寒 湿热郁阻三焦寒热往来 肺胃热盛乳娥 痰热闭肺鼾眠 肝火上炎头胀 肝郁气滞经前乳胀 脾宵积热流铤 瘟毒发黄 疲火扰心善喜 邪入营分发热 肝郁化火经行吐衄 心血不足烦躁 心经积热舌肿 风热挟湿红疹 气滞血瘀沩胎 肝阳化风四肢麻木 饮热互结腹部硬满 肝风内动半身麻木 热毒炽盛大便失禁 脾伤疳积目札 津气亏虚白痏 胎热丹毒（俗称游火） 热毒炽盛痄腮 乳积乳房红肿 热炽营血壮热 阳明腑实心中懊侬 肝胆火盛抱轮红 肝风内动手颤 肝风痰热小儿抽动 瘀血内结烦躁 气随血脱异位妊娠 疾火内扰烦躁 疲疲互结把胖 阳明捬实烦躁 热毒蕴肠异嗜 表寒郁热烦躁 毒热炽盛天疱疮 气滞血班难产 心脾积热银口 胎毒菹结丹毒 毒热炽盛丹毒 热陷心包神昏 肝郁妊娠心腹胀满 肝郁气滞皮肤褐斑 气滞血瘀妇人腹痛 湿热壅滞带状疱疹 阴虚火旺不射精 瘀血阻滞鼾眠
小旗痛	膀胱阻滞小腹痛 膀胱湿热小旗痛 肾虚寒褰小腹痛
大便失禁	脾肾阳虚大便失禁 热毒炽盛大便失禁 气虚下陷大便失禁
黑睛云翳	风热余邪云翳 胃阴不足云翳 肾阴亏损云翳 气滞血疲云翳
精液清冷	肾气不足精液清冷 沉寒痼冷精液清冷
梦游	心肺阴虚梦游 痰浊阻滞梦游 肝气郁结梦游 痰火扰心梦游 心气亏虚梦游 心肾不交梦游 褒血阻滞梦游
口臭	胃火燔齿牙齿浮动 肺胃热盛咽喉白腐 脾胃积热阴疮 胃热阴伤消渴 食滞胃脑口臭 火毒内侵悬雍下垂 宵热熏蒸经行口廉 宵肠积热经行便血 胃火呃逆 胃火炽盛妊娠消渴 湿热结单腹胀大 胃热炽盛消瘦 痰热蕴肺口臭 脾胃热盛口唇焦裂 伤食腹泻 胃火燔龈牙龈蒌缩 胃热炽盛口臭 胃热呕吐 心脾积热口疮 胃火炽盛鼻衄 肺胃热盛乳娥 胃肠积热粉刺 胃热恶心 心脾积热银口 乳食积滞尿白 风火熏迫大扬便血 胃火血热经行吐衄 脾宵积热流铤 靑腿牙疳 肺胃热盛咽肿 胃肠实热小便黄赤 肝热妊娠呕吐
腰痠	阴虚阳亢生风四肢抽搐 肾精亏虚手舞足蹈 肾虚腰痠 肾阴虚舌疮 肝胆湿热尿频 阴虚火旺皮肤褐斑 肝肾阴虚夜盲 气虚黄带 肝肾虚腰膝无力 阴虚火旺血精 肾虚水泛妊娠肿胀 肾虚痰阻气喘 肝肾阴虚阴痛 肾阳虚衰女阴白斑 肾阳虚咳嗽 脾肾阳虚经行泄泻 肾气亏虚滑胎 相火偏旺滑胎 劳损腰痠 阳虚水泛身重 心肾不交健忘 虚寒五色带 肾元亏损耳内流旅 沉寒痼冷精液清冷 阴虚火旺远视 肺肾气虚妊娠咳嗽 肝肾阴虚便血 阴虚齿燥牙齿浮动 湿热壅滞阴道异常出血 肾阳虚胎动不安 阳虚水泛气喘 肾阴亏虚尿痛 血瘀湿热不孕 肾阳不足遗尿 阴虚火旺妊娠尿血
夏季热	上盛下虚夏季热 暑伤肺胃夏季热
心下悸	水气凌心心下悸 阴虚火旺心下悸 痰火扰神心下悸 心阳虚心下悸
耳衄	肝火上逆耳衄 阴虚火旺耳衄
舌苔黄腻	肝胆湿热胁痛 湿热腹泻 风热痰盛口颊澳烂 肺火上炎鱼胞 热结旁流腹泻 湿热熏蒸头汗 风热湿毒耳痒 脾胃湿热手足汗出 湿热发黄 湿热上犯视瞻昏渺 湿热结单腹胀大 胃肠湿热大便胺血 热毒壅盛鼠蹊肿痛 湿热下注臁疮 肝胆湿热耳内流脓 肝胆湿热舌苔黄腻 酒毒内蕴白睛红赤 湿热阴挺 湿热侵淫痿废 湿热阻痹骨痛 湿热下注阴痒 肝胆湿热耳胀闷 肝郁血热腋窝红肿 湿热壅遏眼睑丹毒 湿热蕴积黄汗 余毒流注鼠溪肿痛 湿热里急后重 脾胃积热目畏热 风热挟湿红疹 痰火扰心妄听妄视 湿热郁蒸但热不寒 火毒凝滞腋窝红肿 热重于湿阴肿 大肠湿热舌苔黄腻 疾热结胸舌苔黄腻 肝胆湿热腋汗 肝经湿热女阴白斑 睥胃湿热呕吐 脾胃湿热胬肉 痰热蕴肺口臭 湿热蕴结四肢肿胀 署湿吐泻 湿热阻滞下肢生疽 痰热闭肺舌苔黄腻 湿热下注胫痠 湿热蘊结肛裂 湿热阻络红斑 湿热郁蒸心中懊侬 胃肠湿热蕴毒便血 湿热蕴蒸头重 脾胃湿热脐漏 湿热雄结便难 湿热郁阻白痏 痰火口唇红肿 脾经湿热鼻痒 湿热龜结研腹痛 脾肺积热赤膜下垂 湿热内苔皮肤褐斑 风湿夹热瞳神缩小 湿热郁蒸鼻肿 署湿籩结肩背痈肿
背冷	风寒束表背冷 痰饮内伏背冷
耳聋	热灼肾阴舌苔灰黑 肝胆湿热阴疮 心肾不交耳聋 肝肾虚腰膝无力 肾阳虚面色熏黑 风热袭肺耳聋 肝火耳聋 暑湿蕴蒸面诟 肾阳亏虚耳胀闷 肝经湿热腰如翔束 温热时毒颜面红肿 肝肾亏虚痴呆 胎毐内藴杨梅疮 肾阴虚耳聋 肝肾阴虚舌蒌 脾肾阳虚四肢瘦削 阴虚火旺瞳神散大 肝肾两亏流泪 痰火耳聋 肝肾阴虚阴疮 肝肾阴虚耳胀闷 肾虚失藏小便抉精 肝火上炎头热 阴精亏拫赤脉传睛 肾元亏损耳内流旅 肾阴亏虚尿浊 脾胃虚弱耳聋 肾阴欲竭舌光 肾精不足嗜睡 髓亏头倾 肝血不足耳费 邪入少阳胁痛 肾阴虚咽干 肝阳上亢耳聋 肾精不足骨痛 气滞耻嵌耳聋 肝火上炎舌衄 肾气不足耳聋
四肢疼痛	热邪阻络四肢疼痛 湿热阻络四肢疼痛 湿邪狙络四肢疼痈 风邪阻络四肢疼痛 寒邪阻络四肢疼痛 气血亏虚四肤疼痛 肝肾亏虚四肢疼痛
经行情志异常	心血不足经行情志异常 肝郁气滞经行情志异常 痰火上扰经行佾志异常
颜面浮肿	肺气虚弱颜面浮肿 脾阳不足颜面浮肿
腰脊痛	风寒湿阻腰脊痛 太阳伤寒腰脊痛 瘀血腰脊痛 肾虚腰脊痛 阴虚火旺咳血
牙齿痠弱	风寒袭络牙齿痠弱 脾肾气虚牙齿痠弱
皮肤糜烂	阴虚湿阻糜烂 脾湿内蕴糜烂
无名肿毒	热毒壅聚无名肿毒 风寒外侵无名肿毒
无汗	风寒袭络半身麻木 风寒侵犯小儿音哑 风寒表实无汗 外感风寒发热 暑伤肺胃消渴 外感寒湿舌苔白腻 风寒束表恶寒 湿著肌表身痛 风寒袭络手颤 太阳伤寒头冷 寒湿袭表舌苔白 寒湿腰冷 风寒表证口噤 风邪犯表产后发热 寒邪外束寒战 风寒束表舌苔白 风寒束表面色白 太阳伤寒腰脊痛 风寒束表啮齿 寒疲阻肺哮鸣 表寒里热无汗 寒邪束表面色青 外感惊风 风寒欲解鼻衄 外感暑邪发热 湿热壅盛痱子 热极肢厥手足厥冷 风寒鼻流涕 风寒束表四肢拘急 风寒束表项强 邪伏阴分五心烦热 风寒闭肺气喘 风寒腰冷 凉燥袭肺恶寒 暑伤肺胃夏季热 寒热错杂哮鸣 风寒妊娠咳嗽 风寒咽痛 风寒袭肺耳胀闷 风寒束表身痛 风邪犯表足热 表寒郁热烦躁 风湿疠气麻木 风寒袭肺喷嚏 靑腿牙疳 寒湿束表无汗 风寒产后发痉 风寒袭表恶寒发热 外感风寒经行身痛 热毒壅盛妇人腹痛 风寒袭肺白睛溢血
腰痛	肺脾肾虚肛周疮毒 肝肾虚腰膝无力 沉寒痼冷精液清冷 肾虚腰痛 瘀血阻络展痛 寒湿阻络产后腰痛 肾亏血虚产后腰痛 风寒湿腰痛 湿热阻辨腰痛 带脉不利腰如绳束 肾阳虚崩潘 气血两虚阴道异常出血 瘀血腰脊痛 肾阳虚产后浮肿
舌红绛	虚热便血 阳盛实热舌红绛 暑热惊风 阴虚风内动手颤 阴虚内热舌红绛 阴虚风动小儿抽动 邪毒内陷心肝 热毒内陷营血鼻肿 热入营血面色红 疫毒供灼气营丹痧 热入营血暴盲
小儿呕吐	惊恐呕吐 睥胃湿热呕吐 胃气虚弱呕吐 脾肾阳虚呕吐 乳食积滞呕吐 外邪客宵呕吐 胃阴不足呕吐
皮肤红斑	血热风燥红斑 阴虚火旺红斑 湿热阻络红斑 风邪外袭红斑 风热伤营红斑 脾不统血红斑 脾虚湿盛天疱疮
鼻干	肝经风热流泪 胃火炽盛鼻衄 肺脾气虚鼻干 肺热津伤瘘废 肺经热盛鼻干 胃热炽盛鼻干 肺燥阴虚鼻干 燥热伤津目干涩 肺阴虚咽干 肺肾阴虚鼻塞 风热壅肺鼻衄 肺燥津亏口渴 燥邪伤肺鼻干 肺经郁热粉刺 燥干清窍面诟
面部脱屑	阴虚血燥面部脱屑 血热风燥面部脱屑 脾胃湿热面部脱屑
足趾渍烂	火毒蕴结足趾渍烂 外感邪毒足趾渍烂
鼻流涕	气虚鼻流涕 风热鼻流涕 燥热鼻流涕 风寒鼻流涕 肾虚鼻流涕 湿热鼻流涕
偏头痛	寒饮内停偏头痛 褒血犯头偏头痛 肝阳上扰偏头痛
脐疮	气血不足脐疮 毒热内盛脐疮
独语	褒气郁结独语 心气虚独语 气滞血褒独语
闭经	脾胃气虚闭经溢乳 肝肾阴虚经断前后诸症 肝肾阴虚毛发脱落 肾气亏虚闭经 肾阳虚衰女阴白斑 气滞血疲闭经 脾肾不足煤形红斑 肾阳虚不孕 气血虚弱闭经 痰湿阻滞闭经 阴虚血燥闭经 气滞血疲蝶形红斑 心肾不交经断前后诸症 脾肾拓虚毛发脱落 肝郁化火闭经溢乳 脾肾阳虚经断前后诸症
囟门凸起	火毒上攻囟门凸起 寒气凝聚囟门凸起
小儿舔舌	脾经伏热舔舌 脾虚津乏舔舌
疳积	或食脾胃损伤疳积 病后失调疳积
蟹睛	肝胆实火蟹睛 阴虚火旺蟹睛 脾虚气陷疳翳 热毒壅盛星翳 气虚肝热蟹睛
胎萎不长	气血两虚胎萎不长 气滞血瘀胎萎不长 阴虚血热胎萎不长 肾气亏虚胎萎不长
小儿多汗	阴血亏虚多汗 脾胃积热多汗 表虚不固多汗 营卫不和多汗
足痛	肝肾阴虚足痛 风湿痹阻足痛 寒湿凝滞足痛
过期不产	气滞血褒过期不产 血两虚过期不产
反胃	阴虚血搡反胃 胃寒呕吐 气阴两虚反胃 胃阴虚胃痈 胃阴虚舌剥 酒积湿热反胃 寒饮内停反胃 疲血阻滩反宵 虫积反胃 脾胃虚寒反胃 疾气互结反胃 胃阴干涸舌光 命门火衰反胃
经行浮肿	脾虚湿滞经行浮肿 气滞血疲经行浮肿 脾肾阳虚经行浮肿
背痛	气血瘀滞背痛 疾热阴虚粟疹 寒湿侵袭背痛
经行抽搐	肝郁血虚经行抽搐 血虚经行抽搐 风痰经行抽搐
杨梅疮	湿热下注杨梅疮 毒热炽盛杨梅疮 胎毐内藴杨梅疮 毒邪流窜杨梅疮
里急后重	气虚里急后重 寒湿大便脓血 肠道湿热少腹痛 津伤血虚里急后重 湿热肛门疼痛 大肠湿热舌苔黄腻 气滞里急后重 湿热下注直肠息肉 胃肠湿热大便胺血 时发时止大便脓血 暑入厥阴大便脓血 湿热龜结研腹痛 湿热蕴结大便变形 湿热里急后重 湿热獲结肛门生痔 大肠湿热壮热
上吐下泻	署湿吐泻 食滞吐泻 时疫霍乱吐泻 虚寒吐泻 寒湿吐泻
小儿腹泻	湿热腹泻 脾虚腹泻 风寒腹泻 伤食腹泻
目生椒粟	脾经湿热目生椒粟 脾经风热目生椒粟
面痛	风寒挟痰阻络面痛 风热挟痰阻络面痛 肝郁化火面痛 气虚血瘀面痛
牙痛	齲齿牙痛 气虚齿动牙痛 风寒牙痛 虚火灼齿牙痛 风热犯齿牙痛 胃火燔龈牙痛
膝肿痛	寒湿阻滞膝肿痛 寒湿阻滞腿肿痛 气血两虚膝肿痛 湿热阻滞膝肿痛 湿毒鼉结膝肿痛 肝肾虚损膝肿痛 热毒蕴结膝肿痛
腹泻	湿热腹泻 热结旁流腹泻 食积腹泻 时疫霍乱吐泻 湿热肛门疼痛 寒湿腹搏 肾虚腹泻 痰湿流注结节 肠胃湿热肠鸣 湿热雄结便难 胃肠湿热大便胺血 毒入血分皮肤红线 脾虚腹泻 时发时止大便脓血 风湿唇肿 肝郁脾虚腹泻 脾肾拓虚毛发脱落
外阴疣赘	湿热疫毒外阴疣赘 湿毒凝聚外阴疣赘
暴盲	阴虚火旺暴盲 热入营血暴盲 肝火上逆暴盲
血灌瞳神	肝肾阴虚血灌瞳神 被物所伤血灌瞳神 肝胆火热血灌瞳神 脾不统血血灌曈神 外伤瞳神散大
肛门生痔	风火燥结肛门生痔 湿热獲结肛门生痔 气虚下陷肛门生痔 气血瘀结肛门生痔
妊娠眩晕	气血两虚妊娠眩晕 脾虚痰湿妊娠眩晕 阴虚阳亢妊娠眩晕
小便清长	血虚口唇淡白 寒滞扬道面色青 脾肾阳虚呵欠 肾阳虚畏寒 肾阳亏虚耳胀闷 阳气虚发癍 阳虚寒凝手足紫绀 肾阳虚衰阴冷 肾阳虚不孕 肝肾亏虚关节疼痛 脾肾阳虚紫斑 肾阳不足小便清长 阴寒内盛小便清长 风寒腹泻 脾胃不调鑕虫扰动症 脾胃虚寒胃痛 脾虚湿盛湿疮 少阴寒化恶寒 肾虚寒褰小腹痛
小儿紫癜	瘀血阻络紫癜 脾虚血弱紫癜 阴虚血热紫癜 湿热风毒紫癜
妇人阴冷	肝经湿热阴冷 痰湿下流阴冷 肝气郁结阴冷 肾阳虚衰阴冷 风寒外袭阴冷
口渴	胃阴虚呕吐 肺胃热盛咽喉白腐 湿热熏蒸夭疱疮 阴虚火旺口渴 相火偏旺性早熟 风热外袭恶风 毒热炽盛蝶形红斑 湿热发黄 心脾积热啮齿 热实结胸心中懊侬 胃热炽盛消瘦 暑湿袭表恶寒发热 肺胃火热颈间生疮 痰湿上逆头目胀痛 血热风煉脱屑 风湿热痹阻蝶形红斑 风邪外袭红斑 肝火犯胃头目胀痛 肾阴亏虚消渴 肝郁化火妊娠消渴 毒热浸淫粟疹 风热牙龈肿痛 血热崩中 表寒里热无汗 营卫壅闭黄汗 肺肾阴虚咽肿 外邪客宵呕吐 心火炽盛胬肉 气分邪热风疼 风热犯肺白睛溢血 热毒壅闭咽肿 胃火口唇红肿 风热犯齿牙痛 胃热妊娠呕吐 毒邪浸淫萎缩 痰热惊风 热炽气分口渴 热毒攻心谵语 肝胆郁热瞳神干缺 风热妊娠头痛 水饮内停大便溏 暑伤肺胃夏季热 肺燥津亏口渴 实热费积胚周痈肿 心脾积热口疮 阳明病胃肠燥热心烦 肺热咳痰 阳明经壮热 下焦湿热尿痛 阳盛实热舌红绛 暑湿咳嗽 风热壅肺鼻痠 肺胃津亏瘫痪 暑热伤气但热不寒 风热壅肺鼻痛 心火亢盛妊娠尿血 湿热瑰结腹满 胃火燔龈齿衄 暑伤肺胃消渴 热入营血口渴 心脾实热弄舌 阳明热织角弓反张 心火炽盛心烦 热毒蕴结足热 暑热惊风 胃肠湿热蛔虫扰动症 或食脾胃损伤疳积 热毒内陷营血鼻肿 褒血阻滞梦游 热痞 下焦湿热产后小便淋痈 肠道湿热少腹痛 风火熏迫大扬便血 血热动血汗血 肝火上炎头胀 外感风热经行发热 暑耗肺胄气阴疲乏 痰火扰心小儿多动 血热白庀 瘟毒发黄 余毒流注鼠溪肿痛 湿热里急后重 胃火燔龈牙痛 脾阴虚口唇红肿 湿热壅滞舌苔黄 风热上扰耳内流脓 阴虚津亏产后小便淋痛 火毒凝滞腋窝红肿 风热犯肺喷嚏 毒热蓬结红鼻 阴虚低热 乳积乳房红肿 褒血阻滞脱发 热伤气阴少气 脾胃积热口疮 胃火炽盛鼻衄 热毒炽盛脓疱 虚阳浮越面色红 阳明捬实烦躁 热霍乱转筋 实热便血 表寒郁热烦躁 毒热炽盛天疱疮 胃火血热经行吐衄 心火脾湿夭疱疮 胃阴亏虚妊娠消渴 燥邪伤肺鼻干 风热化火丹毒 湿热蕴蒸口渴 邪热费肺胸闷 胃阴不足食欲不振 痰热藴脾口腻 热盛伤津舌干 膀胱湿热小旗痛 温热时毒颜面红肿 胃实热吐血 大肠热结便难 寒湿中阻腹满 气阴两虚舌光 心火炽盛漏睛 热毒灼营带状疱疹 气滞血瘀单腹胀大 心火炽盛舌纵 阳明实热舌裂 血热郁肤粟疹 肺胃热盛咽肿 心阴虚火旺心烦 肝火上炎面色红 气滞血疲云翳 胃肠实热小便黄赤 火毒乳房红肿 阴虚血热乳头玻裂 风温袭肺鼻煽 外感暑邪发热 胃肠实热舌苔黄 胃热阴伤消渴 热极肢厥手足厥冷 暑湿热郁心烦 睥胃湿热呕吐 湿热壅盛泮肿 邪热壅肺但热不寒 心火上炎口苦 气分热盛烦躁 湿热蘊结脱肛 肺热熏灼舌萎 湿热蕴结四肢肿胀 胃热炽盛口臭 署湿吐泻 血热妄行紫斑 痰饮中阻舌答灰黑 热痰阻肺哮鸣 血热风燥头面瘙痒 外感风温发热 毒热炽盛水痘 暑热伤气潮热 心火炽盛善喜 肺热津伤瘘废 实热腹痛 湿热肛门疼痛 肺胃热盛鼻痛 胃火燔齿牙齿焦黑 血燥筋伤手指挛急 风热鼻塞 胃火炽盛妊娠消渴 血热生风脱发 脾虚津乏舔舌 热毒蕴结膝肿痛 下焦湿热尿浊 湿热阻瘠关节疼痛 湿热阴挺 水饮内停口渴 肺热津伤消渴 燥热伤肺白睛溢血 风热袭肺咽干 肝经郁热妊娠尿血 肺胃热盛乳娥 肺胃蕴热小儿音哑 脏腑实热舌痛 阳明腑实产后大便难 脾宵积热流铤 痰火郁结瞳神散大 阴虚肺燥咳痰 热毒炽盛痄腮 血热崩漏 胃膀血挤吐血 风热壅肺鼻衄 风热犯肺白睛生疳 肺胃热盛妊娠心腹胀满 疫毒内盛咽喉白腐 肺热炽盛壮热 胃火牙銀肿痛 热极或湿热生风四肢抽搐 湿热里结肛门肿胀 风热挟疾颈项痛 燥热伤津目干涩 胃热阴虚齿衄 湿热壅滞粟疼 热邪稍留漏睛 热毒壅聚无名肿毒 热盛动风啮齿 湿热壅滞带状疱疹 疟疾寒战 热毒蕴结尿脓
舌强	风痰阻遏舌强 肝阳化风四肢强直 热入心包舌强 肝阳化风半身不遂 瘀血攻心健忘 痰阻舌麻 金创风毒角弓反张 肝风舌颤 热陷心包神昏
五色带	气郁五色带 虚寒五色带 湿热五色带 阴虚五色带
失嗅	肺脾两虚失嗅 血淤阻肺失嗅 气血两亏失嗅 胆腑郁热失嗅 脾经湿热失嗅 肺经风热失嗅
积滞	过食生冷积滞 脾胃虚弱积滞 肝肾阴虚血灌瞳神 乳食不节积滞
小儿遗尿	肾阳虚弱遗尿 肝经郁热遗尿 脾肺气虚遗尿
汗血	血热动血汗血 气不摄血汗血 阴虚火旺汗血
产后发热	邪毒炽盛产后发热 血瘀产后发热 气虚产后发热 伤食产后发热 风邪犯表产后发热 蒸乳产后发热 血虚产后发热
多梦	肝阳上亢面色红 心胆气虚善惊 肝阴虚阳亢头晕 阴虚火旺尿脓 血不荣润腹筋挛急 心肾阴虚心胸汗出 肝郁血虚四肢抽擄 阴虚火旺吐血 气阴两虚胸痛 血虚面色白 肝热产后乳汁自漏 肝肾阴虚朱砂掌 心肾不交多梦 心脾两虚不寐 心胆气虚多梦 血虚妊娠下放抽筋 水火不济善喜 心火炽盛尿痛 阴虚火旺经行口糜 心脾气虚小儿多动 虚火灼齿牙痛 脾不统血血灌曈神 阴虚火旺烦躁 心阴亏虚小儿心悸 心脾两虚发癫 惊恐伤神心悸 肝肾阴虚经断前后诸症 心脾两虚短气 肺肾阴虚小儿音哑 肝经郁热不寐 气血两虚牙龈蒌缩 心肾不交不寐 心脾两虚脑鸣 血虚舌麻 心脾两虚多梦 肝气郁结小便不通 疲热扰心不寐 心血虚舌不知味 疾气互结反胃 肝血不足耳费 心阴虚火旺心烦 肝阳上扰头晕 痰火扰心妄听妄视 肝阳化风四肢麻木 肝风内动半身麻木 精血亏虚腰背俯偻 阴虚火旺视瞻昏渺 气血失和白斑 心脾气结善忧思 心脾两虚健忘 痰火扰神心下悸 血虚舌颤 肝肾阴虚臁疮 阴虚火旺咳血 血虚神闭痫 精血亏损视瞻昏渺 肝火偏亢月经过多 肝肾阴虚交接出血 肝热阴虚腋汗 火盛白内障 肝阳上亢妊娠头痛 心阴亏虚不寐 肝郁血虚手舞足蹈 阴血亏虚目干涩 心肾不交健忘 肾元亏损耳内流旅 胆热痰扰善疑 营血虚热須发早白 心火炽盛小便黄赤 心脾两虚善疑 肝肾阴虚低热 痰气互结噎膈 心火亢盛不寐 气滞血瘀皮肤肥厚 血虚晕厥 心阴虚心悸 胞宫瘀血经行发热
大便脓血	寒湿大便脓血 阴虚内热大便脓血 胃肠湿热大便胺血 时发时止大便脓血 暑入厥阴大便脓血 下焦虚寒大便脓血 饮食不进大便脓血 感受疫毒大便脓血
小儿丹痧	疫毒侵袭肺胃丹痧 疫毒供灼气营丹痧 肺胃明伤余热丹痧
舌歪	风疲入络流涎 中外风舌歪 中内风舌歪
牙龈蒌缩	肾阴虚牙龈蒌縮 胃火燔龈牙龈蒌缩 气血两虚牙龈蒌缩
皮肤脓疱	热毒炽盛脓疱 湿毒蕴结脓疱 湿热内蕴脓疱 营血郁热脓疱
疲乏	肺气虚少气 脾阳虚产后浮肿 心气亏虚小儿心悸 血虚胎动不安 肾气亏虚胎萎不长 心脾虚弱经行先后无定期 气血两虚胞衣先破 气血两虚妊娠头痛 脾虚湿热鼻臭 气血虚弱闭经 阴虚动风头摇 气血两虚阴道异常出血 气虚血瘀头昏 心脾气虚小儿多动 脾肾拓虚毛发脱落 寒湿中阻腹满 气血两虚难产 气血两虚皮肤风疫 脾不统血血灌曈神 气虚产后乳汁自漏 气血两虚面具脸 脾肾阳虚肥胖 脾气虚白带 腑肾阳虚食欲不振 脾胃气阴两虚口甜 脾虚血亏发黄 阳虚舌边齿痕 血不养筋手指挛急 气血两虚疲乏 肝肾亏虚关节变形 脾不统血红斑 肝气犯胃食欲不振 暑耗肺胄气阴疲乏 气血两虚产后浮肿 脾肺气虚产后大便难 心气虚少气 气血两虚沩胎 气血两虚夜盲 阳气不足头汗 肺肾阴虚咽肿 气不摄血汗血 中气下陷肛门重坠 脾气虚弱夜盲 心气虚心悸 气血两虚胎死不下 脾气虚妊娠小便不通 血两虚过期不产 痰浊上蒙云雾移睛 心脾两虚经前不寐 气血两虚便血 气虚肝热蟹睛 脾胃气虚暧气 脾不统血鼻紐 气虚带环后阴道异常出血 阴虚火旺耳衄 热伤气阴少气 肾阳虚寒咽喉白腐 精血亏损视瞻昏渺 气血两虚妄想 气虚阴挺 气虚恶露不断 血热妄行紫斑 外伤胎动不安 虚寒便血 心脾两虚善疑 气血两虚妄听妄视 气血两虚毛发脱落 外伤胎漏 虚寒肛漏 肾虚火旺耳痒 脾气虚头重 气虚下陷鱼胞 脾虚湿因疲乏
头面瘙痒	虫毒侵袭头面瘙痒 风热上扰头面瘙痒 血热风燥头面瘙痒
舌青	血挤五硬 瘀血内阻噎膈 寒凝阳虚舌青 疲血阻滞舌青 心血挤阻胸痛
轮上赤豆	肺经燥热轮上赤豆 气虚肝热轮上赤豆 肝经火旺轮上赤豆 脾虚兼痰轮上赤豆 肺肝郁热轮上赤豆 阴虚火炎轮上赤豆
口流涎	风疲入络流涎 脾胃积热流涎 疲火扰心善喜 肾虚不摄流涎 脾虚不敛流涎 风中经络流涎
遗尿	肺热津伤消渴 肺脾气虚尿频 阳脱半身不遂 内闭外耽神昏 阴虚阳浮半身不遂 肺气虚寒遗尿 肾阴不足遗尿 肝经郁热遗尿 肾气亏虚尾闾痛 脾肺气虚遗尿 肾阳虚惫夜间多尿 脾虚气陷遗尿 肾阳不足遗尿
经行口糜	阴虚火旺经行口糜 宵热熏蒸经行口廉
白睛生疳	脾胃湿热白睛生疳 心火上乘白睛生疳 风热犯肺白睛生疳 脾胃虚寒白睹生疳
手足脱屑	血虚风燥手足脱屑 虫毒侵袭手足脱屑 风湿蕴肤手足脱屑
四肢拘急	肝血亏虚四肢拘急 寒湿苔结四肢拘急 亡阳液脱四坡拘急 风寒束表四肢拘急 热盛伤津四肢拘急 湿热浸淫四肢拘急 湿热阻滞面具脸
粉刺	湿毒血疲粉刺 毒热粉刺 胃肠积热粉刺 血热扮刺 肺经郁热粉刺
喉中痰鸣	痰火化风喉中痰鸣 痰热闭肺舌苔黄腻 风疲内闭神昏 痰蒙清窍喉中痰鸣 风疲入络口眼呙斜 痰热阻肺喉中痰鸣 痰浊扰心健忘 痰热闭肺鼻煽 风痰阻遏舌强 痰壅气阻喉中痰鸣 痰热内闭半身不遂 肝风痰热小儿抽动 睥肾两虚喉中痰鸣
胎死不下	气血两虚胎死不下 湿阻气滞胎死不下 气滞血瘀胎死不下
不孕	肾阳虚不孕 虚寒赤白带 气血两虚不孕 阴虚血热不孕 肾阳虚面色熏黑 血瘀湿热不孕 肾阳虚畏寒 肝郁气滞不孕 痰湿阻滞不孕
抱轮红	肝胆火炽曈神缩小 脾胃实热抱轮红 肝胆郁热瞳神干缺 肝胆火盛抱轮红 气虚风胜抱轮红 湿热蕴蒸云雾移睛 气滞血瘀瞳神缩小 肝肾阴虚瞳神干缺 肝胆火热血灌瞳神 脾胃积热目畏热
经来驟止	寒邪凝滞经来骤止 热入血室经来骤止 气部结经来骤止 瘀血阻滞经来隳止
乳头破裂	肝郁化火乳头玻裂 阴虚血热乳头玻裂
足跟痛	肝肾亏虚足跟痛 外伤所致足里痛 肾虚腰脊痛 风寒湿阻足跟痛 气血亏虚足跟痛
口噤	寒邪直中口噤 胎毒发寒 血虚产后发痉 阳明热织角弓反张 气郁痰壅口噤 寒湿阻络角弓反张 外伤风毒口噤 血瘀产后眩晕 风寒表证口噤 阴血亏虚口噤 风邪入侵四肤强直 里热壅盛口噤 金创风毒角弓反张 血热风盛角弓反张 湿热阻滞面具脸
皮肤瘙痒	风湿皮肤瘙痒 风盛皮肤瘙痒 风寒皮肤痛痒 风湿蕴肤手足脱屑 血虚皮肤瘙痒 风邪袭表恶风 风热外袭恶风 血虚风燥妊娠瘙痒 肝胆湿热妊娠疫痒 血热皮肤瘙痒
经断前后诸症	肝肾阴虚经断前后诸症 心肾不交经断前后诸症 心脾两虚经断前后诸症 脾肾阳虚经断前后诸症
脐下悸动	肾不纳气脐下悸动 水停下焦脐下悸动 水寒气从少腹上冲
小儿厌食	胃阴亏虚厌食 脾运失健厌食 脾胃气虚厌食
舌卷	热陷心包舌卷 肝经气绝舌卷
白痏	湿热郁阻白痏 津气亏虚白痏
鼻翼煽动	痰热闭肺鼻煽 胂肾两伤务煽 肺热咳痰 津气亏虚白痏 风温袭肺鼻煽
哮鸣	阴虚痰阻哮鸣 阳虚痰阻哮鸣 寒疲阻肺哮鸣 热痰阻肺哮鸣 寒热错杂哮鸣
肌肤麻木	风邪袭络顔面抽描 肝血亏虚四肢拘急 湿邪狙络四肢疼痈 湿胜着痹关节疼痛 气血两虚麻木 瘀血阻滞麻木 痰湿阻滞麻木 风湿疠气麻木
产后小便頻数与失禁	气虚产后小便頻数与失禁 肾阴虚产后小便频数与失禁 肾阳虚产后小便频数与失禁 外伤产后小便频数与失禁
湿疮	湿热壅遏眼睑丹毒 湿热下注湿疮 脾虚湿盛湿疮 血疲风燥湿疮 湿热浸淫湿疮
妊娠下放抽筋	寒凝妊娠下肢抽筋 血虚妊娠下放抽筋
善怒	肝郁气滞善怒 肝胆火旺善怒 肝郁气滞发癫 肝气郁结小便不通 肝火犯胃吐血 脾虚肝乘善怒 肝肾阴虚善怒
头冷	太阳伤寒头冷 督脉虚寒头冷
上环后阴道异常出血	气虚带环后阴道异常出血 阴虚血热带环后阴道异常出血 肝郁血热带环后阴道异常出血
皮肤风疹	风热菹肤皮肤风疹 风寒束表皮肤风疹 血热皮肤风疹 血瘀皮肤风疹 胃肠积热皮肤风疹 气血两虚皮肤风疫
四肢强直	痰热动风四肢强直 湿热阻络四肢强直 阳气虚衰四肢强直 肝阳化风四肢强直 肝肾亏虚四肢强直 血瘀气滞四肢强直 风邪入侵四肤强直 风寒湿阻四肢强直
崩漏	血热崩漏 肾阳虚崩潘 脾不统血舌衄 肾阴虚崩漏 血褒崩漘 脾气虚崩獮
目偏视	风邪中络目偏视 风热上攻目偏视 肝风内动目偏视 痰湿阻络目偏视 禀賦不足目偏视 疲血凝滞目偏视 偏废性目偏视
皮肤白斑	气血失和白斑 暑湿袭表白斑 虫积白斑
小便失禁	肝肾阴虚小便失禁 肾气虚寒小便失禁 膀胱蓄热小便失禁 肺脾气虚小便失禁 风痰上扰啮舌 肾阳虚惫夜间多尿
瞳神缩小	肝胆火炽曈神缩小 气滞血瘀瞳神缩小 风湿夹热瞳神缩小 肝肾阴虚瞳神缩小
头重	肝阳上亢面色红 痰浊上蒙晕厥 痰湿经行头痛 痰湿中阻食后困顿 湿热蕴蒸脑鸣 脾气虚妊娠小便不通 脾经湿热失嗅 湿热妊娠小便不通 酒积湿热反胃 湿热上犯视瞻昏渺 脾虚湿困耳内流脓 风湿犯头头重 寒湿袭表舌苔白 风湿犯表项强 肝风内动口眼呙斜 脾虚痰湿妊娠眩晕 湿热浸淫四肢拘急 脾气虚弱喷嚏 肝胆湿热舌苔黄腻 痰火内扰妊娠心烦 风湿妊娠头痛 脾阳不振小便不利 脾虚肝旺妊娠疫厥 痰火阻肺鼻痠 风湿犯表颈项痛 湿热蕴蒸头重 湿困脾阳嗜睡 脾虚舌胖 脾虚气滞妊娠心旗胀满 肺脾气虚鼻塞 脾胃湿热白睛生疳 痰湿内阻头晕 湿热壅遏眼睑丹毒 脾气虚头重 外感暑邪发热 肝阳上扰头晕
经行身痒	血虚经行搭瘺 血虚经行身痒 风热经行身痒 风寒经行身痒
眼生痰核	痰湿阻滞眼生痰核 痰火郁滞眼生痰核
恶风	风邪中络目偏视 风寒束表咳嗽 风寒袭络半身麻木 误食中毒顔面红肿 风热犯肺气喘 风热外袭头胀 外感风寒发热 气虚产后多汗 风热外袭乳娥 肺经风热鱼胞 风热外袭恶风 风水相搏浮肿 肺气阴两虚气喘 风热犯肺浮肿 风热犯肺鼻痒 寒湿阻滞腿肿痛 风热鼻塞 风寒袭络手颤 风湿犯头头重 风邪外袭口眼呙斜 风寒犯头头痛 卫气亏虚恶风 风寒束表舌苔白 脾气虚弱月经过多 风热喉痒 邪留肺卫低热 外感风邪手舞足蹈 风热袭肺咽干 风邪袭表恶风 风寒羞明 风寒湿侵足颤 肺燥喉痒 营卫不和汗出偏沮 风热鼻流涕 风寒牙痛 风温袭肺鼻煽 外感暑邪发热 风热犯肺白睛溢血 风胜行痹关节疼痛 风热上扰耳内流脓 卫分邪热风疹 风寒束表四肢拘急 外邪干胃呕吐 风热犯肺喷嚏 阴虚肺燥咳痰 营卫不和自汗 风热犯肺耳胀闷 风中经络四肢麻木 风热妊娠咳嗽 风热妊娠头痛 风热声音嘶哑 风寒束表红疹 营卫不和多汗 风热外侵眼皮眺 风热犯头头痛 风寒袭肺浮肿 风热羞明 风邪犯表足热 风湿外袭恶风 热痰阻肺哮鸣 风中经络流涎 表虚风湿腰重 风热壅肺鼻痠 外感风温发热 风热咽痛 外感风寒经行身痛 风热袭肺咳瞅 风寒湿邪壅滞鼻痛
指头疔肿	外感邪毒指头疔肿 脏嘛火毒指头疔肿 火毒瑄结指头疔肿
头皮麻木	痰湿阻络头皮麻木 血虚头皮麻木
面色红	肝阳上亢面色红 风热外袭面色红 虚阳浮越面色红 阴虚内热面色红 肝火上炎面色红 阳明经证面色红 热入营血面色红 外邪客宵呕吐 心经积热舌肿 胃旸实热肥胖
经前面部粉剌	肺热经前面部粉刺 肝经郁火经前面部粉刺 肝经湿热经前面部粉刺
经行身痛	血疲经行身痛 血虚经行身痛 外感风寒经行身痛
妊振腹痛	血虚妊娠腹痛 气虚妊娠腹痛 虚寒妊振腹痛 风寒妊振腹痛 气滞妊娠腹痛
睑弦赤烂	火毒攻目目赤烂 血虚受风睑弦赤烂 湿热偏盛睑弦赤烂 郁火上冲睑弦赤烂 脾虚夹湿睑弦赤烂
脑鸣	心脾两虚脑鸣 髓亏脑鸣 湿热蕴蒸脑鸣 肝气郁滞脑鸣
直肠息肉	湿热下注直肠息肉 寒湿内生直肠息肉
朱砂掌	瘀血阻络红丝赤缕 肝肾阴虚朱砂掌 褒血内阻朱砂掌
头痛	风寒束表咳嗽 痰湿经行头痛 肝胆火炽曈神缩小 疫毒侵袭肺胃丹痧 肝风舌麻 误食中毒顔面红肿 外感风热白睛红赤 外感风寒发热 脾气虚弱视物变形 痰湿阻滞妊娠头痛 风热外袭乳娥 肝气郁结视物变形 肝火上炎白睛溢血 燥热伤肺咽干 寒湿腹搏 火毒上攻囟门凸起 风热犯肺鼻痒 肝火上逆耳衄 风热上攻目偏视 肝阳化风四肢强直 邪毒内陷心肝 肺胃火热颈间生疮 风邪入络上胞下垂 毒热炽盛脱屑 外感风寒经行发热 肝阳上亢经行头痛 风邪袭络顔面抽描 痰湿上逆头目胀痛 风湿妊娠头痛 毒热炽盛杨梅疮 风寒束表啮齿 肝郁气滞经行情志异常 肝火犯胃头目胀痛 肝胆湿热耳胀闷 心肝火旺经前不寐 外感风热水痘 湿热鼻流涕 营卫不和汗出偏沮 肝郁血热腋窝红肿 火毒凝结肩背痈肿 血疲经行头痛 风热妊娠发疹 血热郁肤粟疹 瘀血阻窍嘈睡 胆腑郁热失嗅 外感惊风 风寒欲解鼻衄 外感暑邪发热 风热犯肺白睛溢血 肝阳上扰头痛 热毒壅闭咽肿 痰火扰心善愤 肝阳化风半身不遂 外邪干胃呕吐 湿热蕴蒸颈后生痈 毒邪浸淫萎缩 风寒束表项强 肝胃积热颈间生疮 风热侵犯小儿音哑 热毒攻心谵语 肝胆郁热瞳神干缺 凉燥袭肺恶寒 风热妊娠头痛 肝肾两虚老花眼 寒湿阻络角弓反张 湿热蕴蒸云雾移睛 挤血犯头头痛 风热犯肺恶寒发热 肝胆火热赤膜下垂 风热外侵眼皮眺 风寒咽痛 火毒盖结臀部痈肿 疳热攻肺鼻肿 风热犯头头痛 肝阳上亢妊娠头痛 署湿吐泻 风寒妊娠头痛 风中经络半身不遂 风邪犯表足热 血淤阻肺失嗅 脾虚肝旺妊娠疫厥 脾虚湿阻盗汗 肝风舌颤 毒热蕴滞丹毒 邪毒炽盛产后发热 外感风温发热 风水相搏身重 风寒袭表恶寒发热 外感风寒经行身痛 热毒壅盛妇人腹痛 风热袭肺咳瞅 暑热伤气但热不寒 气滞耻嵌耳聋 风热壅肺鼻痛 外感咳血 风邪中络目偏视 风热上犯痄腮 风寒表实无汗 湿热蕴蒸脑鸣 血虚受风经行目痛 风湿犯头头痛 脾经湿热失嗅 肝胆火热血灌瞳神 外感寒湿舌苔白腻 气血两虚妊娠头痛 湿毒血疲粉刺 脾虚湿热鼻臭 时行疫毒咽喉白腐 暑热惊风 风热鼻塞 热深厥深身热肢寒 太阳伤寒头冷 热毒壅盛鼠蹊肿痛 风邪外袭口眼呙斜 风寒表证口噤 风寒犯头头痛 肝胆湿热耳内流脓 风热喉痒 湿著肌表身重 风热犯肺咽肿 肝胆郁热口苦 燥热伤肺白睛溢血 风热袭肺咽干 湿热郁阻三焦寒热往来 阴虚肝旺妊娠痉厥 热毒侵肺鼻痒 风湿犯表颈项痛 邪入少阳口苦 太阳伤寒腰脊痛 肺经热盛鼻干 火毒炽盛皮肤红线 风寒妊振腹痛 心火赤脉传睛 外感风热经行发热 痰瘀互结痫 风热鼻流涕 寒邪束表面色青 痰浊犯头头痛 撞击外伤白睛溢血 风热伤营红斑 风寒束肺胸闷 风热上扰耳内流脓 下焦血瘀尿痛 肝风内动半身麻木 风寒鼻流涕 风热袭肺耳聋 气滞血褒独语 毒邪流窜杨梅疮 脾气虚头痛 热毒炽盛痄腮 肝阳上亢头目胀痈 班血阻络面具脸 褒血阻滞脱发 风寒腰冷 风热妊娠咳嗽 阴虚火旺头目胀痛 风寒束表红疹 肝风内动手颤 风寒妊娠咳嗽 热毒壅肺鼻肿 肝火偏亢月经过多 实火上炎口颊溃烂 热毒炽盛脓疱 金疮风毒项强 肝风内动目偏视 湿热蕴蒸头重 郁火上冲睑弦赤烂 风痰郁结痰核流注 风寒喉痒 燥热鼻流涕 风寒袭肺喷嚏 毒入血分皮肤红线 风热咽痛 痰火内扰妄想 阴虚阳浮消渴 疟疾寒战 燥邪伤肺鼻干 阴血亏虚头痛 肝胆湿热鼻臭 金创风毒角弓反张 肝胆火盛白睛红赤
声音嘶哑	肺肾阴虚声音嘶哑 热邪犯肺声音嘶哑 肺阴虚咽干 风寒声音嘶哑 风热侵犯小儿音哑 风热声音嘶哑 肺胃蕴热小儿音哑 血瘀痰聚声音嘶哑 肺燥咳嗽
食欲不振	胃寒嘈杂 脾阳虚产后浮肿 肝气郁结舌纵 热结旁流腹泻 气虚黄带 风热湿毒耳痒 胃阴不足食欲不振 肝气郁结视物变形 脾胃虚寒流瘅 脾霣气虚食欲不振 脾气亏耗头倾 气血虚弱闭经 肝郁脾虚腹泻 醇气虚面色蒌黄 寒湿中阻腹满 气血两虚皮肤风疫 气滞湿阻腹露青筋 脾虚湿滞经行浮肿 肝郁脾虚经前乳胀 腑肾阳虚食欲不振 湿热遂阻肛门流脓 脾胃阴虚手足汗出 气滞胎位不正 疳积喜食异物 火毒炽盛皮肤红线 心脾两虚视物变形 脾不统血红斑 肝气犯胃食欲不振 脾胃气虚消瘦 睥虚湿泛妊振肿胀 脾虚腹泻 气不摄血汗血 脾气虚脱形 脾肾阳虚经断前后诸症 气阴两虚反胃 气虛低热 脾气虚食后困顿 肝胃不和恶心 脾气虚头痛 热毒炽盛痄腮 气血两虚便血 脾不统血鼻紐 脾胃虚寒食欲不振 脾阳虚衰舌苔白 气血两虚远视 脾虚肝亢小儿抽动 痰湿内阻言语错乱 湿热蘊结肛裂 湿热郁蒸心中懊侬 伤食食欲不振 痰食凝结腹中痞块 上盛下虚夏季热 虫积消瘦 时发时止大便脓血 湿热郁蒸鼻肿 阳虚津不上承舌干
指（趾）缝湿烂	脾虚湿蕴指（趾）缝湿烂 湿毒浸淫指（趾）缝湿烂 湿热内蕴指（趾）缝湿烂
潮热	阴虚火旺暴盲 暑热伤气潮热 肾精亏虚下肢生疽:多发于儿童及靑年 肾阴虚产后小便频数与失禁 气血亏虚颈后生痈 阴血亏虚多汗 阴虚内热舌红绛 肝肾阴虚朱砂掌 阴虚火旺红斑 心肾不交多梦 脾胃阴虚痞块 阴虚阳亢善疑 阴虚火旺烦躁 阴虚火旺口唇焦裂 疳积脾虚手足心热 心肾不交脏躁 肝肾阴虚经断前后诸症 肝肾阴虚血灌瞳神 阴虚火旺远视 心肾不交梦游 虚热肛漏 阴虚咽痛 心肾不交不寐 肺阴虚消瘦 脾胃湿热白睛生疳 心阴虚火旺心烦 阴虚阳盛经间期出血 肝肾阴虚白睛红赤 热入营分谵语 气阴两虚咽痛 气阴两虚针眼 心血不足盗汗 虚热结聚胚周痈肿 阴虚肺燥咳痰 瘀血内郁潮热 阴虚低热 肝肾阴虚瞳神缩小 阳明热结挤腹痛 脾胃气虚潮热 肝肾阴虚月经过多 阳明瞄实发热 阴虚妊娠咳嗽 阴虚火炎胞内生肉 心阴亏虚不寐 阳明腑实潮热 肝肾阴亏崩中 肾阴欲竭舌光 虫积疳翳 阴虚血热不孕 阴虚血亏潮热 痰气交阻乳房肿块
小儿浮肿	湿热壅盛泮肿 肾阳衮微浮肿 风水相搏浮肿 睥阳不振浮肿
小儿发黄	寒湿发黄 湿热发黄
胞衣不下	气虚胞衣不下 寒凝胞衣不下 血丧胞衣不下
初生不乳	脏有伏寒不乳 胃有秽浊不乳 元气虚弱不乳
产后小便淋痛	下焦湿热产后小便淋痈 阴虚津亏产后小便淋痛 心火亢盛产后小便淋痛
脏躁	肝郁气滞脏躁 痰热郁结脏躁 心肾不交脏躁 阴虚阳充脏燥
善恐	气血两虚善恐 肝胆不足善恐 肾精不足善恐
白带	脾气虚弱月经过多 气虚阴挺 脾湿下注女阴白斑 虚热赤白带 脾气虚白带 湿热白带 相火偏旺性早熟 肝郁湿热赤白带 肾阳虚畏寒 脾虚痰湿性早熟 湿重于热阴肿 肾阳虚白带 湿热菹结经行睃痛 痰湿阻滞不孕 肾气亏虚闭经 脾气虚弱交接出血 瘀血凝滞流产后闭经 气血两虚流产后闭经 痰湿白带 血瘀瘫瘕 贤虚供亏痫 虚寒赤白带 寒湿中阻腹满
腿肿痛	寒湿阻滞腿肿痛 湿热阻痹腰肿痛 瘀血阻络腿肿痛
大便溏	痰湿经行头痛 湿热瑰结腹满 脾虚气陷疳翳 肝肾虚腰膝无力 脾胃阳虚慢惊 气血两虚舌光 脾气亏耗头倾 脾肾阳虚经行泄泻 或食脾胃损伤疳积 脾虚寒湿舌肿 气滞湿阻腹露青筋 脾肾阳虚肥胖 寒湿发黄 脾肾阳虚呵欠 疳积脾虚手足心热 脾不统血发癍 中气下陷大便溏 脾肾阳虚脐腹痛 脾胃阳虚腹冷 阳虚寒凝手足紫绀 脾胃气虚消瘦 睥虚湿泛妊振肿胀 脾肾阳虚紫斑 气阴两虚羞明 脾气虚弱经行泄泻 脾气虚脱形 胃寒干呕 脾气虚少气 脾肾阴虚箱口 肺脾肾虚肛周疮毒 寒滞扬道面色青 寒湿内生直肠息肉 睥虚肝乘口酸 水饮内停大便溏 阴寒内盛小便清长 脾虚痰湿妊娠眩晕 脾不统血经行吐衄 脾肾阳虚呃逆 脾肾阳虚胎水肿满 疲油中阻肥胖 脾虚肝亢小儿抽动 食滞脾胃低热 脾虚湿蕴鼾眠 脾胃气虚大便溏 虫积消瘦 饮气痞 肾阳衰微大便溏 脾胃不调鑕虫扰动症 脾肺气虚咳血 气虚舌边齿痕 脾肾阳虚经行浮肿 脾虚气陷尿浊 脾虚湿因疲乏 脾胃虚寒异嗜
头昏	气血瘀阻耳痛 阴虚火旺蟹睛 肾阴虚证口咸 痰火扰心善愤 脾气虚食后困顿 肾阳虚脱肛 毒邪流窜杨梅疮 血虚神闭痫 肝肾阴虚善怒 阴虚内热蝶形红斑 肺脾两虚失嗅 贤虚供亏痫 脾虚湿困耳内流脓 阴虚火旺红斑 气虚血瘀头昏 脾气虚弱喷嚏 肾精亏虚头昏 虚火上炎口颊溃烂 痰火耳聋 心胆不宁善疑 肾虚失藏小便抉精 血淤阻肺失嗅 肾虚不摄流涎 风火燥结肛门生痔 肾阴虚皮肤黑斑 肺脾气虚鼻塞 气血两虚牙龈蒌缩 痰瘀互结痫 湿热壅滞阴道异常出血 湿疲阻络半身麻木 瘀血阻窍嘈睡 阴血亏虚目视无神 肺脾气虚鼻疫 肾虚水泛多唾 风湿夹热瞳神缩小 肝肾阴虚头昏
白睛鱼胞	肺火上炎鱼胞 阴虚内热鱼胞 肺经风热鱼胞 气虚下陷鱼胞
腹冷	冲任虚寒经行腹痛 虚寒妊振腹痛 寒湿阻络产后腰痛 肾阳虚衰妇人腹痛 肾阳虚衰女阴白斑 肾阳虚衰阴冷 寒凝积冷挤腹痛 肾阳虚不孕 寒凝产后腹痛 脾肾阳虚经行泄泻 寒湿凝滞经行政痈 寒湿凝滞妇人腹痛 寒湿凝滞伪胎 冲任虚寒腹冷 寒滞肝脉腹冷 肾阳虚腹冷 脾阳虚畏寒 中焦寒湿肠鸣 脾胃阳虚腹冷 脾肾阳虚脐腹痛 寒凝恶露不下 风寒妊振腹痛 月经过少 湿阻气滞胎死不下 肝郁肾虚经前乳胀 外感风寒经行身痛 寒凝胞衣不下 胃寒干呕 肾虚寒褰小腹痛
小儿痞块	脾胃阴虚痞块 脾胃气虚痞块 疟各痞块
皮肤褐斑	阴虚火旺皮肤褐斑 湿热内苔皮肤褐斑 肝郁气滞皮肤褐斑
低热	湿热蘊结低热 气血虚衰肛门流脓 肺肾阴虚咽喉白腐 气虛低热 气虚低热 气郁低热 虚热结聚胚周痈肿 心虚禀弱啼哭 肝肾阴虚臁疮 睥气虚夹热舌疮 阴虚火旺咳血 虚火上炎乳蛾 血热恶露不断 阴虚内热蝶形红斑 邪伏阴分五心烦热 肝肾阴虚朱砂掌 湿热五色带 营卫不和多汗 肺胃明伤余热丹痧 虚火上炎重舌 湿郁低热 肝郁化火经行发热 邪留肺卫低热 血瘀产后发热 心阴亏虚小儿心悸 疳积喜食异物 血瘀低热 湿热菹结经行睃痛 阳虚低热 疳积低热 肝肾阴虚低热 肺胃阴虚低热 嵌血发黄 气血不足脐疮 肝肾阴虚慢惊 湿热瘀结妇人腹痛 阴虚血热紫癜 肝肾阴虚瘫痪 血瘀湿热不孕 心阴虚心悸 阴虚火旺经行发热 胞宫瘀血经行发热 惊恐惊风
肌肤疼痛	脾肾阳虚肌肤疼痛 心脾两虚肌肤疼痛 毒热炽盛肌肤疼痛
红疹	风热挟湿红疹 血虚不荣红疹 湿热壅盛痱子 热入营血红疹 风寒束表红疹
腰膝无力	肾虚腰痠 肝肾亏损云雾移睛 肝肾虚腰膝无力 肾气不固尿频 寒湿腰膝无力 脾肾阳虚呃逆 湿热腰膝无力
恶寒发热	外感咳血 风寒表实无汗 外感风热白睛红赤 湿热熏蒸头汗 外感风寒发热 外感寒湿舌苔白腻 湿著肌表身痛 暑湿流注鼠蹊肿痛 外感风寒舌肿 暑湿袭表恶寒发热 寒湿袭表舌苔白 热毒壅盛鼠蹊肿痛 湿热下注臁疮 风湿犯表颈项痛 火毒炽盛皮肤红线 风寒妊振腹痛 肺燥喉痒 肝郁血热腋窝红肿 火毒凝结肩背痈肿 风热相搏眼睑丹毒 脏嘛火毒指头疔肿 外感风热漏睛 风寒腹泻 寒邪束表面色青 外邪客宵呕吐 风寒欲解鼻衄 余毒上攻口颊攒烂 火毒凝滞腋窝红肿 湿热蕴蒸颈后生痈 风寒束表项强 风寒闭肺气喘 风热犯肺恶寒发热 寒热错杂哮鸣 风湿犯表项强 风寒妊娠咳嗽 火毒盖结臀部痈肿 风寒袭肺耳胀闷 风寒束表身痛 金疮风毒项强 风湿客表恶寒发热 表寒郁热烦躁 走马牙疳 阳明经壮热 风寒外侵无名肿毒 肺脾积热胞睑肿胀 毒热蕴滞丹毒 寒湿阻滞腹筋挛急 风寒袭表恶寒发热 外感风寒经行身痛 风寒袭肺白睛溢血 金创风毒角弓反张 风寒妊娠音哑
面色白	寒湿阻滞膝肿痛 真热假寒面色白 肺脾气虚鼻干 虚阳浮越面色红 风寒束表面色白 气虚低热 外感风寒发热 阳虚面色白 寒滞肠道面色白 阳脱面色白 脾气下陷脱肛 血虚面色白
经行泄泻	脾肾阳虚经行泄泻 脾气虚弱经行泄泻
小儿鸡胸龟背	邪客脊骨龟背 肺积痰热鸡胸 胎禀怯弱鸡胸龟背
口苦	肝胆火炽曈神缩小 脾胃实热黄液上冲 肝胆火旺善怒 肝阴虚阳亢头晕 脾胃积热流涎 肝郁化火经间期出血 毒热炽盛肌肤疼痛 肝郁化火口酸 痰火扰心心悸 肝火上炎白睛溢血 痰火扰心梦游 火郁五心烦热 肝经湿热腰如翔束 湿热妊娠尿痛 肝火上逆耳衄 湿热赤白带 肝经湿热性早熟 湿热结单腹胀大 胃热干呕 痰热郁结脏躁 心胆气虚多梦 肝胆湿热丹毒 下焦湿热小便不通 肝郁化火闭经溢乳 肝阳上亢经行头痛 肝胆实火蟹睛 热入血室经来骤止 肝经湿热阴茎溃烂 膀胱湿热尿血 胃热痰浊上逆舌腐 肝胃不和嘈杂 肝气郁滞胸闷 肝郁气滞经行情志异常 肝经郁热不寐 湿热下注阴痒 肝胆湿热耳胀闷 酒毒内茧舌紫 心肝火旺经前不寐 肝郁化火妊娠消渴 湿热鼻流涕 肠胃湿热肠鸣 气滞湿阻小便不利 肝胆湿热尿血 热入血室妄听妄视 肝经实热目畏热 胆腑郁热失嗅 肝郁气滞视瞻昏渺 湿热蕴积黄汗 肝热妊娠呕吐 肝阳上扰头晕 邪阻半表半里盗汗 虚热赤白带 胃热阴伤消渴 邪入少阳寒热往来 痰火扰心善愤 肝火耳聋 肝胃不和恶心 宵肠积热经行便血 肝郁气滞目珠自胀 肝胆热毒耳痛 肝胆湿热鼻塞 肝胆湿热腋汗 肝郁气滞经行腹痛 心火上炎口苦 邪郁少阳恶寒 湿热下注尿白 湿热蕴蒸云雾移睛 痰热蕴肺口臭 痰阻舌麻 肝胆湿热妊娠疫痒 肝火犯胃宵痛 实热妊娠尿痛 膀胱湿热小便黄赤 肝气郁结梦游 肺热咳嗽 下焦湿热尿痛 肝火上逆暴盲 心火亢盛不寐 湿热雄结便难 肝胆湿热小便黄赤 邪入少阳胁痛 湿热龜结研腹痛 肝郁血虚 脾肺积热赤膜下垂 肝郁血虚瘫痪 肝气郁滞脑鸣 肝火上炎舌衄 脾虚湿因疲乏 肝火犯肺鼻衄 肝阳上亢面色红 肝胆湿热胁痛 肝胆湿热尿频 湿毒下注经断复行 肝胆火热血灌瞳神 肝郁气滞目昏 燥火内结肛裂 火盛目痒 肝热产后乳汁自漏 肝胆湿热耳内流脓 肝胆湿热舌苔黄腻 肝郁化火经行发热 湿热遂阻肛门流脓 肝胆郁热口苦 邪入少阳口苦 肝经火盛胬肉 肝肾阴虚经断前后诸症 脏腑实热舌痛 风火熏迫大扬便血 外伤邪毒阴疮 肝火上炎头胀 肝气郁结小便不通 痰火扰心小儿多动 肝胆郁热咽干 疲热扰心不寐 疲火扰心善喜 湿热内蕴舌苔灰黑 肝郁化火经行吐衄 肝郁善太息 心经积热舌肿 湿热内蔥小便挟精 湿热便血 下焦血瘀尿痛 肝胆湿热阴疮 膀胱蓄热小便失禁 痰火扰神心下悸 湿热内阻小便不利 肝经湿热女阴白斑 肝胆火盛抱轮红 湿热下注胚门重坠 肝郁化火面痛 肝火偏亢月经过多 火盛白内障 肝火充盛消瘦 肝火上炎头热 肝经湿热阴痛 肝风内动目偏视 肝火犯胃吐血 胆热痰扰善疑 表寒郁热烦躁 肝气犯胃吞酸 风热郁结肛门瘙痒 湿热蒙蔽神昏 痰火扰神痫 郁火上冲睑弦赤烂 风阳上扰头摇 湿热壅滞带状疱疹 燥热鼻流涕 靑腿牙疳 肝胃不和呕吐 肝胆火盛白睛红赤
不寐	热入营血面色红 肝郁血虚四肢抽擄 阴虚肺燥咳痰 心脾两虚经前不寐 血虚阴亏手足心热 阴血亏虚多汗 肝肾阴虚手舞足蹈 热炽营血壮热 心火上炎口苦 胆虚气怯不寐 心脾两虚不寐 心血虚心悸 心火炽盛尿痛 热入营血但热不寒 疾火内扰烦躁 心阴亏虚不寐 热入营血发癍 阴虚火旺烦躁 肝郁血虚手舞足蹈 阴虚血热带环后阴道异常出血 肾阴亏损尿血 脏腑实热舌痛 肝经郁热不寐 余热扰服不寐 心肝火旺经前不寐 心肾不交不寐 心火亢盛不寐 疲热扰心不寐 气血不足转筋 肾阴亏虚尿频 心血不足烦躁 血热风盛角弓反张 热入营血烦躁
牙齿焦黑	胃火燔齿牙齿焦黑 风冷客经牙齿焦黑 下焦热盛牙齿焦黑
流产后闭经	瘀血凝滞流产后闭经 气血两虚流产后闭经 肝气郁结流产后闭经
多唾	水饮凌心小儿心悸 脾胄虚寒多唾 肾虚水泛多唾
舌边齿痕	阳虚舌边齿痕 气虚舌边齿痕
尿后余沥	中气不足尿后余沥 膀耽湿热尿后余沥 脾肾阳虚便难 脾肾阳虚夜盲 肾虚不摄流涎 肾虚胞寒尿后余沥
手足紫绀	气郁阻络手足紫绀 阳虚寒凝手足紫绀 气虚血挤手足紫绀
小儿心悸	心阳亏虚小儿心样 水饮凌心小儿心悸 气阴两虚小儿心悸 心气亏虚小儿心悸 心阴亏虚小儿心悸 心血瘀阻小儿心悸 心胆虚怯小儿心择 热毒侵及小儿心样 心血亏虚小儿心悸
痱子	暑湿内苔痱子 湿热壅盛痱子
视物变形	湿热上犯视瞻昏渺 脾气虚弱视物变形 肝肾阴虚视物变形 精血亏损视瞻昏渺 肝气郁结视物变形 心脾两虚视物变形 气滞血淤视物变形
脐出血	脐结松脱脐出血 胎寒不足脐出血
经行目痛	肝热受风经行目痛 肝虚血亏经行目痛 血凝翳留经行目痛 血虚受风经行目痛
股阴痛	寒湿浸淫股阴痛 气虚血褒股阴痛 肾阳虚衰股阴痈 湿热浸淫股阴痛
女阴白斑	脾湿下注女阴白斑 肝经湿热女阴白斑 肝肾阴虚女阴白斑 肾阳虚衰女阴白斑 血虚肝旺女阴白斑
脐湿	热毒壅结脐湿 湿热浸淫脐湿
弄舌	脾肾虚热弄舌 痫证弄舌 心脾实热弄舌
交接出血	脾气虚弱交接出血 冲任湿热交接出血 肝肾阴虚交接出血
口唇焦裂	阴虚火旺口唇焦裂 脾胃热盛口唇焦裂
腹痛	寒邪直中舌紫 津伤血虚里急后重 诸虫积滞异嗜 寒滞肠道面色白 血虚胎动不安 蝈虫内扰脐腹痛 实热腹痛 寒凝腹痛 寒凝积冷挤腹痛 气逆气从少腹上冲 气血两虚经行旗痛 血疲经行身痛 肝气郁结少腹痛 胃肠湿热蛔虫扰动症 湿热风毒紫癜 睥肾气虚骨痛 乳食不节积滞 脾肾拓虚毛发脱落 血瘀产后腰痛 伤食积滞啼哭 血虚口唇淡白 虚寒腹泻 食滞吐泻 阴虚内热大便脓血 气滞胎动不安 腑肾阳虚食欲不振 时疫霍乱吐泻 食积腹痛 脾肾阳虚脐腹痛 阳气郁阻手足厥冷 肠胃气滞脐腹痛 蝈虫啮齿 风寒腹泻 膀胱阻滞小腹痛 寒湿大便脓血 虚寒腹痛 气虚妊娠腹痛 寒邪直中口噤 寒滞扬道面色青 胎毒发寒 阳明热结挤腹痛 大肠湿热舌苔黄腻 血热恶露不断 肝郁气滞经行腹痛 肝气郁结流产后闭经 血褒腹痛 伤食腹泻 脾虚肝乘善怒 肝脾不和肠鸣 血疲恶露不下 伤食积滞脐腹痛 实热便血 血疲产后身痛 感受疫毒大便脓血 虚寒便血 食滞宵肠啮齿 气虚胎动不安 过食生冷积滞 脾肾阳虚肠鸣 寒湿困脾畏寒 时发时止大便脓血 脾胃不调鑕虫扰动症 湿热龜结研腹痛
阴挺	气虚阴挺 湿热阴挺 肾气虚阴挺 气血两虚阴挺
咳痰	外感咳血 瘀阻肺络咳血 肺热咳痰 湿热蘊肺咳痰 肾阳虚衰小便不利 肺肾阴虚小儿音哑 阴虚肺燥咳痰 风邪犯肺咳痰 肺寒咳痰 肺阴虚消瘦 外感风温发热 风寒喉痒 肺热壅盛咳血 痰浊阻滞胸痛 湿邪犯肺咳痰
肛裂	燥火内结肛裂 湿热蘊结肛裂 血虚肠煉肛裂
小便频数	气虚阴挺 阴虚津亏产后小便淋痛 心火亢盛产后小便淋痛 膀耽湿热尿后余沥 实热妊娠尿痛 肾气虚胫痠 肺脾气虚尿频 肾气虚阴挺 睐胱湿热尿频 肾阴亏虚消渴 肾气不固尿频 肾阳虚衰妇人腹痛 肾虚胞寒尿后余沥 阴虚五色带 血虚阴亏手足心热 气虚产后小便頻数与失禁 膀胱湿热尿频 肾阴亏虚尿频 虚热妊娠尿痛 肝肾不足小儿靑盲 肾气虚胎漏 肾气虚月经过少 肾阳虚妊娠小便不通
外阴肿痛	外伤阴肿 湿重于热阴肿 热重于湿阴肿
老花眼	气血两虚老花眼 肝肾两虚老花眼
牙齿浮动	胃火燔齿牙齿浮动 气虚牙齿浮动 阴虚齿燥牙齿浮动 气虚齿动牙痛
咳嗽	风寒束表咳嗽 肺气虚少气 肺阴虚喉痒 肺胃热盛咽喉白腐 风寒侵犯小儿音哑 疫毒侵袭肺胃丹痧 风热犯肺气喘 外感风寒发热 肺经风热鱼胞 风水相搏浮肿 扭伤颈項痛 风热犯肺浮肿 风热犯肺鼻痒 肺寒咳痰 阴虚血燥闭经 痰浊阻滞胸痛 脾虚痰湿妊娠咳嗽 外感风热水痘 表寒里热无汗 肺胃阴虚低热 风热妊娠发疹 肺胃热盛咽肿 肝火犯肺咳嗽 外感惊风 痰湿咳嗽 湿邪犯肺咳痰 风温袭肺鼻煽 一、湿热初侵，邪犯肺胃 风热犯肺白睛溢血 脾虚咳嗽 肾阳虚咳嗽 风热犯肺耳胀闷 寒邪客肺畏寒 邪热壅肺但热不寒 凉燥袭肺恶寒 痰饮壅盛憋气 肺经燥热鼻痒 风热犯肺恶寒发热 痰热蕴肺口臭 风寒咽痛 肝肾阴虚瘰疬 燥热妊娠咳嗽 痰火耳聋 湿热咽痛 血淤阻肺失嗅 肺热咳痰 痰饮中阻舌答灰黑 肺火背热 肺热咳嗽 肺燥咳嗽 暑湿咳嗽 外感风温发热 风水相搏身重 风寒袭表恶寒发热 疼毒外达肺部苔热《见形期〉 风热袭肺咳瞅 脾肺气虚咳血 风寒袭肺白睛溢血 肺经风热失嗅 痰饮内伏背冷 风热壅肺鼻痛 风寒表实无汗 肺热津伤瘘废 肺气虚咳嗽 脾经湿热失嗅 痰热阻肺顿咳 风寒痰阻顿咳 肺气壅滞小便不通 热毒侵及小儿心样 肺阴虚妊娠音哑 风寒声音嘶哑 风热犯肺咽肿 痰浊阻肺气喘 肺经蕴热胬肉 肺胃蕴热小儿音哑 肺经热盛鼻干 眙禀亏虚小儿脐突 肺燥阴虚鼻干 风邪犯肺咳痰 肺气失宣小便不利 肺脾气虚鼻塞 风热鼻流涕 风寒束肺胸闷 卫分邪热风疹 肺脾肾虚肛周疮毒 风寒鼻流涕 风热犯肺喷嚏 肺阴虚咳嗽 血虚阴亏手足心热 风寒闭肺气喘 风热妊娠咳嗽 风热声音嘶哑 风寒妊娠咳嗽 肺热炽盛壮热 痰热闭肺舌苔黄腻 风寒束表身痛 痰火阻肺鼻痠 麻毒时邪由里出表〔初热期〉 热壅血瘀胸闷 风寒喉痒 燥邪伤肺咳嗽 肺气失宣鼾眠
皮肤结节	痰湿流注结节 气血瘀滞结节 寒湿阻络结节 疫气浸淫结节 痰火郁结结节
经前不寐	阴虚火旺经前不寐 心脾两虚经前不寐 心肝火旺经前不寐
善悲	阴虚阳亢善疑 肝郁气滞呵欠 心脾两虚发癫 脏躁善悲 心肺气虚善悲
慢惊	肝肾阴虚慢惊 脾胃阳虚慢惊 脾肾阳虚慢惊
针眼	脾气虚弱针眼 热毒炽盛针眼 外感风热针眼 气阴两虚针眼
咽喉痛	湿热咽痛 风热咽痛 郁火咽痛 气阴两虚咽痛 风寒咽痛 阴虚咽痛
小便黄赤	肝经湿热阴冷 痰火扰心妄听妄视 湿热下注阴部水疱 湿热蒙蔽谵语 风水相搏浮肿 气阴两虚胸痛 热重于湿阴肿 酒积湿热反胃 热炽气分口渴 热毒蕴结足热 湿热中阻口腻 胃火炽盛妊娠消渴 热深厥深身热肢寒 肝肾阴虚朱砂掌 胃肠湿热蛔虫扰动症 毒热粉刺 血热扮刺 热痞 下焦湿热尿浊 署湿吐泻 血热风燥红斑 拖接初期恶寒 膀胱湿热小便黄赤 阳明捬实烦躁 肺胃热盛乳娥 寒湿郁滞小便黄赤 湿热阻络红斑 食滞宵肠啮齿 心火炽盛小便黄赤 湿热下注产后浮肿 肝胆湿热小便黄赤 湿热瘀结妇人腹痛 胃肠实热小便黄赤 阴虚内热小便黄赤 肝郁化火经行吐衄 肝火上炎舌衄 气分邪热风疼 湿热内蕴指（趾）缝湿烂
咽肿	热毒壅闭咽肿 风热犯肺咽肿 肺胃热盛咽肿 肺肾阴虚咽肿
头晕	阴虚火旺暴盲 肝阴虚阳亢头晕 热灼肾阴舌苔灰黑 阴虚火旺皮肤褐斑 痰火扰心心悸 血虚胎动不安 阴虚阳亢妊娠眩晕 肾亏血虚产后腰痛 阴虚火旺心中懊侬 脾虚湿盛臁疮 阴精不足远视 肾阴虚喷嚏 阴虚火旺赤脉传睛 气血两虚面具脸 肝肾阴虚耳胀闷 血虚阴亏便秘 肝胆湿热耳胀闷 肝肾亏虚关节疼痛 气血两虚夜盲 肾阴亏损云翳 气虚下陷阴痛 肝阳上扰头晕 心血亏虚小儿心悸 虚热赤白带 血虚产后胁痛 气血两虚胎死不下 气虚产后发热 肝肾阴虚 血虚产后发热 肝肾阴虚阴痛 肝肾阴虚足痛 气血两虚妊娠眩晕 肾精亏虚头晕 肾阴虚牙龈蒌縮 痰阻舌麻 肾气虚胎漏 气血两虚远视 肾阳虚妊娠小便不通 疲油中阻肥胖 肾阴虚损鼻衄 心肾不交健忘 肝肾不足转筋 肝肾阴亏崩中 血虚风燥妊娠瘙痒 肝肾虚损膝肿痛 阳虚低热 肝肾阴虚便血 痰滞妊娠呕吐 痰湿内阻头晕 肾阴亏虚尿痛 气血两虚四肤瘦削 心肾阴虚心胸汗出 气血亏虚汗出偏沮 风热挟痰阻络面痛 肾气亏虚胎萎不长 气血两虚妊娠头痛 肝肾阴虚四肢瘦削 气滞血疲蝶形红斑 阴虚风动神昏 肝肾阴虚视物变形 血虚口唇淡白 睥虚夹湿经行眩晕 肝肾阴虚阴疮 肝肾阴虚小便失禁 肾阴亏损尿血 血虚失荣妇人腹痛 阴虚肝旺妊娠痉厥 血虚产后身痛 气血虚弱消瘦 肝肾阴虚面具脸 肝气上逆咽中异物感 肝肾亏拫须发早白 肾阴虚咽干 肝郁化火经行吐衄 血虚经行眩晕 肝阳化风四肢麻木 气血两虚膝肿痛 肝郁阴虚经前乳胀 阴虚内热红丝赤缕 肝肾阴虚瞳神缩小 肾气亏虚闭经 肝阳上亢头目胀痈 肾阴虚火旺牙龈肿痛 气血两虚指甲变异 阴虚火旺耳衄 肝肾亏虚痴呆 阴虚火旺头目胀痛 肝经风热流泪 血虚不荣红疹 肝经湿热阴痛 血虚妊娠发疹 气虚产后血崩 气虚阴吹 胆热痰扰善疑 肾阴亏虚尿浊 肝肾阴虚毛发脱落 湿热蕴蒸头重 肝肾阴虚经行腹痛 气血两虚滑胎 气血两虚流产后闭经 气血两虚脐漏 气血不足转筋 肾阴亏损星翳 肾阴虚妊娠音哑 肝胆湿热鼻臭 阴虚火旺发癍 肝风舌麻 心气亏虚小儿心悸 肝肾阴虚夜盲 痰湿阻滞妊娠头痛 肝血不足夜盲 心脾虚弱经行先后无定期 肾阳虚衰妇人腹痛 气滞血疲呵欠 阴虚火旺流泪 肝阳化风四肢强直 心肾不交多梦 心胆气虚多梦 水火不济善喜 血虚月经过少 阴虚血亏便难 肝经湿热阴茎溃烂 气血两虚脱形 脾虚血亏发黄 肝肾阴虚血灌瞳神 肾虚不摄流涎 肝肾亏虚关节变形 气血两虚臂痛 肾精亏虚面色黧黑 气阴两虚瞳神散大 肝火上炎面色红 肝肾亏虚四肢强直 阴虚内热小便黄赤 阴虚肺燥经行吐衄 肝肾阴虚瘫痪 气不摄血汗血 风痰经行抽搐 阴血亏虚口噤 阴虚阳充脏燥 肝郁血虚经行抽搐 脾气虚头晕 肾阳虚白带 血虚妊娠腹痛 气血两虚舌淡白 气血两虚经行发热 肝肾两虚老花眼 阴虚产后多汗 血虚皮肤瘙痒 肝阳上亢妊娠头痛 肝肾阴虚腹露青筋 血虚经行头痛 阴虚血热带环后阴道异常出血 肾元亏损耳内流旅 血虚燥热舌搭 肾阴虚崩漏 肺肾气虚妊娠咳嗽 血虚风煉脱屑 肝火上逆暴盲 肝肾阴虚低热 气血两虚妄听妄视 肝血亏虚顔面抽搐 阴虚血热不孕 气血两虚动风角弓反张 肝肾阴虚头昏 气滞耻嵌耳聋 肝火上炎舌衄 心阴虚心悸 外感咳血 血不荣润腹筋挛急 血虚头皮麻木 气血两虚舌光 血虚面色白 肝郁气滞目昏 气血虚弱乳房胀痛 气血两虚经行旗痛 胆虚气怯不寐 肝肾阴虚朱砂掌 阴虚火炎舌衄 肾虚腰脊痛 肝肾阴虚步态不稳 肝血亏虚四肢拘急 气血两虚老花眼 脾肾两虚夜间多尿 肝胆郁热口苦 心肾不交脏躁 肝肾阴虚经断前后诸症 阴虚火旺远视 心肾不交不寐 虚热便血 肝肾阴虚阴部水疱 气血两虚胎萎不长 气血两虚产后浮肿 痰瘀互结痫 心肝阴虚颈粗 阴虚齿燥牙齿浮动 肝虚血亏经行目痛 气阴两虚羞明 气血两亏失嗅 肝肾亏虚足跟痛 气虚齿动牙痛 血虚产后腹痛 阴虚肝旺晕厥 阴虚火旺妊娠尿血 肝风内动半身麻木 阴虚火旺视瞻昏渺 心脾气血两虚头晕 气血两虚不孕 肝郁湿热赤白带 肝肾阴虚瞳神干缺 肾气不固尿频 血虚风动足颤 脾不统血鼻紐 气血虚弱漏下 肝胆火盛抱轮红 髓亏脑鸣 肝风内动手颤 湿热五色带 肾阴虚耳聋 肝火偏亢月经过多 气血两虚浮肿 肝肾亏损云雾移睛 阴血亏虚目干涩 肝火充盛消瘦 肝肾阴虚女阴白斑 肾气虚阴挺 痰气痞 阴虚白内障 肝肾阴虚目昏 阴血亏虚头痛 风痰上扰目昏
小儿痿证	三、邪去正虚，肝肾亏损 二、湿热阻络，气虚血瘀 一、湿热初侵，邪犯肺胃
小儿消渴	肺热津伤消渴 胃热阴伤消渴 阴虚阳浮消渴 暑伤肺胃消渴 肾阴亏虚消渴
白睛红赤	酒毒内蕴白睛红赤 火毒攻目目赤烂 风热羞明 肝热受风经行目痛 外感风热白睛红赤 天行时邪白睹红赤 肝肾阴虚血灌瞳神 脾伤疳积目札 肺脾积热目赤烂 邪热伏络白睛红赤 肝胆火盛抱轮红 肝肺风热赤膜下垂 虫积疳翳 肝肾阴虚白睛红赤 湿热蕴蒸云雾移睛 早期眼胞疲痛 肝胆火盛白睛红赤
鼾眠	痰热闭肺鼾眠 脾虚湿蕴鼾眠 肺气失宣鼾眠 瘀血阻滞鼾眠
喷嚏	肾阳虚喷嚏 卫分邪热风疹 风寒表实无汗 肺气虚寒喷嚏 风寒鼻塞 麻毒时邪由里出表〔初热期〉 风寒鼻流涕 风热犯肺喷嚏 外感风热水痘 扭伤颈項痛 风热犯肺鼻痒 风寒袭肺喷嚏 风寒喉痒 风寒咽痛 肾阴虚喷嚏 肺气虚鼻痒 脾气虚弱喷嚏
手颤	血虚风袭手颤 风痰入络手颤 风寒袭络手颤 阴虚风内动手颤 肝风内动手颤 脾虚动风手颤
手足厥冷	虫扰胆府手足厥冷 寒邪直中口噤 热极肢厥手足厥冷 阴盛格阳身热肢寒 胃热吐蚘 阳虚肾寒手足厥冷 阳气郁阻手足厥冷 寒凝积冷挤腹痛 阳气虚衰四肢强直 热深厥深身热肢寒 寒霍乱转筋 血寒凝滞手足厥冷 痰浊内阻手足厥冷 阳虚筋惕肉哺
皮肤甲错	湿热阻络甲错 血虚风燥甲错 血热风燥甲错 津液亏虚甲错 疲血阻滞舌青
赤膜下垂	肝肺风热赤膜下垂 脾经风热目生椒粟 脾肺积热赤膜下垂 肝胆火热赤膜下垂
难产	气滞血班难产 瘀阻脑络痴呆 气血两虚难产
经行弦晕	睥虚夹湿经行眩晕 阴虚阳亢经行弦晕 血虚经行眩晕
自汗	风邪中络目偏视 肺气虚少气 心气虚掼憋气 气血虚衰肛门流脓 肺脾气虚鼻干 气血两虚四肤瘦削 肾不纳气脐下悸动 心气亏虚小儿心悸 脾虚血弱紫癜 气虚低热 肺气虚弱颜面浮肿 脾胃虚弱月经过少 脾胃气虚半身麻木 肺气阴两虚气喘 气阴两虚胸痛 心肺气虚善悲 火毒上攻囟门凸起 肾不纳气少气 暑热惊风 气虚风热爱明 心气虚独语 精血亏虚脱形 心气亏虚胸痛 风邪犯表产后发热 卫气亏虚恶风 睥肾气虚骨痛 气血亏虚四肤疼痛 营虚半身麻木 气血亏虚足跟痛 热炽阳明自汗 气血两虚善恐 脾气虚弱月经过多 血虚口唇淡白 气虚里急后重 表虚不固多汗 风邪袭表恶风 阳虚面色白 气血两虚疲乏 脾胃积热多汗 心肝阴虚颈粗 心气虚少气 气血亏虚目珠自胀 气血两虚夜盲 肺气不足善忧思 气虚齿动牙痛 阳虚自汗 气虚血瘀面痛 气虚肥胖 心阳亏虚小儿心样 气血亏虚手舞足蹈 气阴两虚反胃 脾气虚头晕 气虚产后发热 气虚舌纵 寒疑气滞胸痛 气虚血褒股阴痛 血虚津亏产后大便难 营卫不和自汗 脾胃气虚潮热 气血两虚舌淡白 肩凝肩不举 脾不统血舌衄 营卫不和多汗 气虚自汗 血瘀气滞四肢强直 暑伤气阴自汗 气虚善太息 热痰阻肺哮鸣 痰湿肩痛 命门火衰目昏 气阴两虚小儿心悸 外感风温发热 肺气虚肥胖 肺积痰热鸡胸 气血两虚动风角弓反张 气虚舌边齿痕
妊振肿胀	睥虚湿泛妊振肿胀 气滞妊娠肿胀 肾虚水泛妊娠肿胀
面具脸	气血两虚面具脸 湿热阻滞面具脸 肝肾阴虚面具脸 班血阻络面具脸
妊娠尿痛	湿热妊娠尿痛 实热妊娠尿痛 虚热妊娠尿痛 气虚妊娠尿痛
异位妊娠	未破损期异位妊娠 气虚血挤异位妊娠 破损期异位妊娠 气随血脱异位妊娠
流泪	脾胃实热抱轮红 气血两虚星翳 脾伤疳积目札 阴虚火旺流泪 邪热伏络白睛红赤 气虚风热爱明 肝胆火盛抱轮红 肝经火旺轮上赤豆 胎毐内藴杨梅疮 气滞血瘀瞳神缩小 风热内积倒睫 肝肾两亏流泪 肝经风热流泪 风邪袭络顔面抽描 肝郁血虚手舞足蹈 肝热受风经行目痛 肺肝郁热轮上赤豆 脾经风热目生椒粟 湿热偏盛睑弦赤烂 风中经络流涎 风热目痒 脾经湿热目生椒粟 肝经虚寒流泪 肝肺风热赤膜下垂 风寒目痒 肝经实热目畏热 肺脾气虚倒睫 肝经风热星翳
半身不遂	风中经络半身不遂 肝风舌麻 气虚血瘀四肢肿胀 阳脱半身不遂 肝阳化风半身不遂 阴虚阳浮半身不遂 中内风舌歪 肝肾亏虚半身不遂 中外风舌歪 气虚血挤半身不遂 风痰阻遏舌强 肝阳化风四肢强直 阴虚风动神昏 痰热内闭半身不遂 疲湿兼闭心窍半身不遂
舌上出血	心火亢盛舌衄 脾不统血舌衄 阴虚火炎舌衄 肝火上炎舌衄
妊娠心烦	肝郁化火妊娠心烦 痰火内扰妊娠心烦 阴虚火旺妊娠心烦
善惊	心胆气虚善惊 惊恐伤神心悸 痰火扰心善愤 肝郁血虚善惊 阴虚火旺发狂 阴虚阳充脏燥 心胆虚怯小儿心择 阴血不足善惊 心火充盛善惊
腹部硬满	阳明腑实潮热 饮热互结腹部硬满 升降失常腹部硬满 热毒籩结腹部硬满
口中生疮	脾宵气虚口疮 阴虚火旺口疮 脾胃积热口疮
囟门下陷	睥肾阳虚脑髓失充囟陷 气液耗损真气下陷囟陷
经行便血	脾不统血经行便血 宵肠积热经行便血
心中懊侬	阳明腑实心中懊侬 热扰胸鎘心中懊侬 心血不足经行情志异常 湿热郁蒸心中懊侬 气阴两伤心中懊侬 阴虚火旺心中懊侬 热实结胸心中懊侬
啮齿	热盛动风啮齿 蝈虫啮齿 风寒束表啮齿 阴虚动风啮齿 心脾积热啮齿 气血两虚啮齿 食滞宵肠啮齿
妊娠心腹胀满	肺胃热盛妊娠心腹胀满 肝郁妊娠心腹胀满 脾虚气滞妊娠心旗胀满
鼠蹊肿痛	暑湿流注鼠蹊肿痛 瘀血流注鼠蹊肿痛 寒凝气滞鼠蹊肿痛 热毒壅盛鼠蹊肿痛 余毒流注鼠溪肿痛
下肢生疽	湿热阻滞下肢生疽 肾精亏虚下肢生疽:多发于儿童及靑年 风寒湿凝滞下肢生疽
初生腹泻	虚寒腹泻 湿热腹泻 风寒腹泻 伤食腹泻
猫眼疮	风寒阻络猫眼疮 风热蕴肤猫眼疮 湿热毒费猫眼疮
妄想	痰气郁结妄想 气滞血瘀妄想 痰火内扰妄想 阴虚火旺妄想 气滞血褒善疑 气血两虚妄想
憋气	心气虚掼憋气 脾肾阳虚憋气 痰饮壅盛憋气 邪热费肺胸闷 肝郁气滞憋气 心血瘀阻胸闷
善食易饥	胃火炽盛善食易饥 胃阴亏虚妊娠消渴 肺胃津亏瘫痪 阳明蓄血善食易饥
牙龈肿痛	风热牙龈肿痛 肾阴虚火旺牙龈肿痛 胃火牙銀肿痛 热毒蕴肠异嗜 风火熏迫大扬便血 胃火血热经行吐衄
尿血	膀胱阻滞小腹痛 脾肾两虚尿血 下焦血瘀尿痛 肾阴亏损尿血 膀胱湿热尿血 肝经郁热妊娠尿血 热入营血面色红 血热动血汗血 肝胆湿热尿血 肾阴亏虚尿痛 湿热风毒紫癜 心火亢盛尿血 热入营血烦躁 阴虚火旺妊娠尿血
小儿青盲	肝经风热小儿青盲 撞击外伤小儿青盲 肝肾不足小儿靑盲 血虚肝郁小儿青盲 脾虚气弱小儿青盲
口唇青紫	疫毒凌心咽喉白腐 瘀阻肺络咳血 邪毒炽盛闭肺内陷《陷逆证》 痰浊阻肺口唇青紫 脾阳虚弱口唇青紫 心肾阳衰面色青 感受疫毒大便脓血 气滞血瘀口唇靑紫 寒犯少阴口唇靑紫
胸闷	气郁伤肺气喘 肝郁气滞脏躁 脾胃实热黄液上冲 邪热费肺胸闷 火郁五心烦热 肝郁气滞腹筋挛急 心血瘀阻小儿心悸 肝气郁结少腹痛 暑湿袭表恶寒发热 心气亏虚胸痛 痰湿阴吹 心胆气虚多梦 肝郁化火闭经溢乳 痰湿上逆头目胀痛 心血瘀阻面色靑 肝胃不和嘈杂 肝气郁滞胸闷 气滞胎位不正 肝郁气滞胁痛 气郁五色带 胸供肩不举 脾运失健厌食 气血亏虚缺盆溃烂 挤血阻滞不射精 湿热壅遏眼睑丹毒 肝郁气滞视瞻昏渺 风痰经行抽搐 气滞血瘀经间期出血 肝热妊娠呕吐 气阴两虚针眼 气滞血瘀口唇靑紫 湿热郁蒸但热不寒 气郁血虚痴呆 肝胃不和恶心 肾虚痰阻气喘 肝郁气滞目珠自胀 情志异常异嗜 肝郁气滞阴痛 肝胆湿热腋汗 痰湿白带 寒邪客肺畏寒 肝郁气滞经行腹痛 气滞血瘀短气 湿热留滞经间期出血 气滞妊娠小便不通 疲油中阻肥胖 湿郁低热 痰湿内阻言语错乱 脾虚肝旺妊娠疫厥 气滞妊娠肿胀 肺热咳嗽 心血褒阻心悸 暑湿咳嗽 脾气亏虚胎水肿满 湿热雄结便难 气阴两虚小儿心悸 痰湿阻滞闭经 暑热伤气但热不寒 风寒袭肺白睛溢血 肝气郁滞脑鸣 肝胆湿热胁痛 水湿困脾浮肿 肝气犯胃经行呕吐 风湿犯头头痛 肝郁血虚四肢抽擄 风热挟痰阻络面痛 肝郁气滞性早熟 心气亏虚梦游 热深厥深身热肢寒 心气虚独语 肝气犯胃暧气 肺气壅滞小便不通 风湿犯头头重 痰湿流注臂痛 湿热蕴结壮热 睥虚夹湿经行眩晕 肝郁脾虚经前乳胀 肝郁化火经行发热 气滞血疲胞衣先玻 湿著肌表身重 湿热郁阻三焦寒热往来 痰湿阻滞不孕 湿热下注产后浮肿 肝郁气滞经前乳胀 热邪犯肺声音嘶哑 肝气郁结阴冷 痰火扰心小儿多动 脾胃湿热白睛生疳 肝郁肾虚经前乳胀 肝气郁结艟神散大 气血褒结颈粗 风湿热郁发癍 痰浊犯头头痛 肝郁善太息 表寒里热气喘 风热挟湿红疹 湿热内蔥小便挟精 心阳亏虚小儿心样 风寒束肺胸闷 气郁疾阻步态不稳 瘀阻肺络咳血 痰湿阻络目偏视 痰凝气滞咽中异物感 痰浊上蒙云雾移睛 毒邪流窜杨梅疮 气滞妊娠腹痛 痰热阻肺喉中痰鸣 痰浊扰心健忘 风寒闭肺气喘 血嵌乳汁不行 心血瘀阻胸闷 寒热错杂哮鸣 肝郁化火面痛 肝火偏亢月经过多 寒湿内阻吞酸 肝郁气滞胃痛 肝经湿热阴痛 肝火犯胃吐血 气滞产后胁痛 肝郁疲凝颈间生疮 气滞血班难产 湿热蕴蒸头重 热壅血瘀胸闷 湿阻气滞头胀 风痰郁结痰核流注 风痰闭神痫 湿疲阻络半身麻木 毒入血分皮肤红线 肝胃不和呕吐 湿热内苔皮肤褐斑 风痰上扰目昏 瘀血阻滞鼾眠
脐漏	脾胃湿热脐漏 气血两虚脐漏
视瞻昏渺	湿热上犯视瞻昏渺 肝肾阴虚目昏 阴虚火旺视瞻昏渺 精血亏损视瞻昏渺 肝郁气滞视瞻昏渺
耳痒	风热湿毒耳痒 肾虚火旺耳痒 脾虚湿浊耳痒
寒热往来	邪阻半表半里盗汗 肝胆湿热尿频 热入血室经来骤止 邪入少阳寒热往来 湿热郁阻三焦寒热往来 肝经郁热妊娠尿血 表寒郁热烦躁 邪入少阳口苦 肝气郁滞胸闷 肝胆郁热咽干 肝胆湿热小便黄赤 热入血室妄听妄视 外感疟部寒热往来 疟各痞块
舌苔白腻	湿热白庀 水湿困脾浮肿 痰湿中阻食后困顿 疲蒙清窍痴呆 风湿犯头头痛 肺经风热鱼胞 外感寒湿舌苔白腻 脾虚湿热鼻臭 湿著肌表身痛 暑湿流注鼠蹊肿痛 脾胃虚弱积滞 邪伏募原恶寒 寒饮内停偏头痛 睥虚湿困疳翳 寒湿中阻腹满 痰浊内阻手足厥冷 风湿皮肤瘙痒 寒湿发黄 痰浊阻肺气喘 寒湿侵袭背痛 湿困脾阳嗜睡 湿痰阻窍痴呆 疾气互结反胃 寒饮内停舌苔白腻 痰浊犯头头痛 风痰经行抽搐 痰湿咳嗽 痰湿阻滞麻木 痰湿阻络目偏视 肾虚风湿阴茎溃烂 外邪干胃呕吐 中内风舌歪 肾虚痰阻气喘 寒湿痹阻汗出偏沮 痰湿白带 风痰挟瘀四肢抽搐 肝气郁结失语 湿热蕴蒸云雾移睛 风疲内闭神昏 风中经络半身不遂 脾虚湿蕴指（趾）缝湿烂 风寒湿凝滞下肢生疽 风湿客表恶寒发热 湿阻膝原舌苔白腻 风痰上扰啮舌 风疲入络口眼呙斜 气虚痰结发癫 湿热蕴蒸头重 湿阻气滞头胀 过食生冷积滞 风痰闭神痫 痰气痞 风痰入络手颤 痰湿阻滞闭经 寒湿束表无汗 痰湿内阻头晕 痰壅气阻喉中痰鸣 湿毒浸淫指（趾）缝湿烂 风痰上扰目昏 风邪入侵四肤强直
黄带	肝经湿热女阴白斑 胃气虚弱呕吐 气虚黄带 湿热黄带 肺热壅盛咳血 肝经湿热经前面部粉刺 湿热下注阴痒 热重于湿阴肿 湿热浸淫股阴痛
带状疱疹	脾虚湿盛带状疱疹 湿热壅滞带状疱疹 气虚血瘀带状疱疹 热毒灼营带状疱疹
胸痛	外感咳血 风热犯肺白睛溢血 热壅血丧胸痛 肺热炽盛壮热 疲疲互结把胖 风热犯肺气喘 寒疑气滞胸痛 阴虚肺燥咳痰 肺热咳嗽 肺燥阴虚鼻干 心血挤阻胸痛 燥热伤肺咽干 气阴两虚胸痛 邪热壅肺但热不寒 胸供肩不举 心气亏虚胸痛 心血瘀阻胸闷 痰热蕴肺口臭 燥邪伤肺咳嗽 燥邪伤肺鼻干 痰浊阻滞胸痛 气滞血瘀短气
妊娠小便不通	脾气虚妊娠小便不通 气滞妊娠小便不通 湿热妊娠小便不通 肾阳虚妊娠小便不通
小儿重舌	虚火上炎重舌 心脾积热重舌
胎动不安	气滞胎动不安 外伤胎动不安 肾阳虚胎动不安 血虚胎动不安 气虚胎动不安 血热胎动不安
晕厥	气虚晕厥 血气上逆晕厥 痰浊上蒙晕厥 气郁痰壅口噤 蜃邪中人晕厥 血虚晕厥 阴虚肝旺晕厥
单腹胀大	脾肾阳虚单腹胀大 湿热结单腹胀大 肝肾阴虚单腹胀大 气滞湿阻单腹胀大 气滞血瘀单腹胀大
产后腰痛	寒湿阻络产后腰痛 肾亏血虚产后腰痛 血瘀产后腰痛
言语错乱	痰湿内阻言语错乱 肝郁气结言语错乱 心睥两虚言语错乱 挤血扰心言语错乱
